user_id,R,F,M,R_score,F_score,M_score,RFM_total,segment
100,5,3,3,2,2,2,6,一般用户
117,5,8,8,2,3,3,8,流失高价值用户
119,5,1,1,2,1,1,4,一般用户
121,8,1,1,1,1,1,3,一般用户
122,1,2,2,4,1,1,6,新用户
1035,5,1,1,2,1,1,4,一般用户
1044,4,1,1,2,1,1,4,一般用户
1072,0,2,2,4,1,1,6,新用户
1095,1,1,1,4,1,1,6,新用户
1105,7,4,4,1,3,3,7,流失高价值用户
1114,3,1,1,3,1,1,5,新用户
1119,4,3,3,2,2,2,6,一般用户
1131,3,2,2,3,1,1,5,新用户
1133,1,1,1,4,1,1,6,新用户
1144,5,1,1,2,1,1,4,一般用户
1149,3,5,5,3,3,3,9,高价值用户
1156,0,4,4,4,3,3,10,高价值用户
1158,0,1,1,4,1,1,6,新用户
1167,8,1,1,1,1,1,3,一般用户
1169,5,1,1,2,1,1,4,一般用户
1189,0,2,2,4,1,1,6,新用户
1192,1,7,7,4,3,3,10,高价值用户
1203,7,1,1,1,1,1,3,一般用户
1234,6,9,9,1,3,3,7,流失高价值用户
1242,5,1,1,2,1,1,4,一般用户
1246,3,1,1,3,1,1,5,新用户
1249,2,23,23,4,3,3,10,高价值用户
1253,2,1,1,4,1,1,6,新用户
1274,4,1,1,2,1,1,4,一般用户
1275,8,1,1,1,1,1,3,一般用户
10008,3,2,2,3,1,1,5,新用户
10009,0,7,7,4,3,3,10,高价值用户
10021,2,1,1,4,1,1,6,新用户
10024,1,3,3,4,2,2,8,潜力用户
10027,2,2,2,4,1,1,6,新用户
10034,0,4,4,4,3,3,10,高价值用户
10035,6,3,3,1,2,2,5,一般用户
10044,5,2,2,2,1,1,4,一般用户
10057,2,5,5,4,3,3,10,高价值用户
10075,4,1,1,2,1,1,4,一般用户
10086,4,2,2,2,1,1,4,一般用户
10111,5,1,1,2,1,1,4,一般用户
10114,3,3,3,3,2,2,7,潜力用户
10128,8,1,1,1,1,1,3,一般用户
10139,4,1,1,2,1,1,4,一般用户
10154,8,1,1,1,1,1,3,一般用户
10156,1,1,1,4,1,1,6,新用户
10170,2,5,5,4,3,3,10,高价值用户
10179,3,1,1,3,1,1,5,新用户
10206,1,1,1,4,1,1,6,新用户
10226,6,1,1,1,1,1,3,一般用户
10230,2,1,1,4,1,1,6,新用户
10236,4,5,5,2,3,3,8,流失高价值用户
10240,2,2,2,4,1,1,6,新用户
10257,1,2,2,4,1,1,6,新用户
10263,4,3,3,2,2,2,6,一般用户
10267,0,3,3,4,2,2,8,潜力用户
10295,8,1,1,1,1,1,3,一般用户
10296,8,1,1,1,1,1,3,一般用户
10297,1,2,2,4,1,1,6,新用户
10299,1,2,2,4,1,1,6,新用户
10301,1,4,4,4,3,3,10,高价值用户
10311,3,1,1,3,1,1,5,新用户
10315,6,1,1,1,1,1,3,一般用户
10365,2,3,3,4,2,2,8,潜力用户
10386,5,2,2,2,1,1,4,一般用户
10396,1,3,3,4,2,2,8,潜力用户
10404,1,1,1,4,1,1,6,新用户
10407,0,3,3,4,2,2,8,潜力用户
10422,7,1,1,1,1,1,3,一般用户
10435,2,1,1,4,1,1,6,新用户
10449,0,1,1,4,1,1,6,新用户
10452,7,1,1,1,1,1,3,一般用户
10458,2,2,2,4,1,1,6,新用户
10465,1,1,1,4,1,1,6,新用户
10469,6,1,1,1,1,1,3,一般用户
10476,0,3,3,4,2,2,8,潜力用户
10485,1,1,1,4,1,1,6,新用户
10487,4,2,2,2,1,1,4,一般用户
10490,1,1,1,4,1,1,6,新用户
10512,0,3,3,4,2,2,8,潜力用户
10514,4,1,1,2,1,1,4,一般用户
10526,0,1,1,4,1,1,6,新用户
10527,0,1,1,4,1,1,6,新用户
10529,4,1,1,2,1,1,4,一般用户
10552,4,1,1,2,1,1,4,一般用户
10608,1,1,1,4,1,1,6,新用户
10618,1,2,2,4,1,1,6,新用户
10622,3,3,3,3,2,2,7,潜力用户
10628,0,2,2,4,1,1,6,新用户
10630,3,1,1,3,1,1,5,新用户
10642,3,1,1,3,1,1,5,新用户
10645,1,1,1,4,1,1,6,新用户
10656,0,2,2,4,1,1,6,新用户
10667,3,1,1,3,1,1,5,新用户
10668,0,4,4,4,3,3,10,高价值用户
10669,5,1,1,2,1,1,4,一般用户
10680,2,1,1,4,1,1,6,新用户
10681,7,9,9,1,3,3,7,流失高价值用户
10683,5,1,1,2,1,1,4,一般用户
10705,3,1,1,3,1,1,5,新用户
10727,6,1,1,1,1,1,3,一般用户
10752,4,1,1,2,1,1,4,一般用户
10757,1,3,3,4,2,2,8,潜力用户
10769,2,1,1,4,1,1,6,新用户
10772,0,5,5,4,3,3,10,高价值用户
10776,2,5,5,4,3,3,10,高价值用户
10777,5,1,1,2,1,1,4,一般用户
10779,0,1,1,4,1,1,6,新用户
10790,3,1,1,3,1,1,5,新用户
10802,1,4,4,4,3,3,10,高价值用户
10809,2,1,1,4,1,1,6,新用户
10836,5,1,1,2,1,1,4,一般用户
10843,3,1,1,3,1,1,5,新用户
10849,3,2,2,3,1,1,5,新用户
10858,3,3,3,3,2,2,7,潜力用户
10871,3,1,1,3,1,1,5,新用户
10877,5,4,4,2,3,3,8,流失高价值用户
10899,0,13,13,4,3,3,10,高价值用户
10923,0,1,1,4,1,1,6,新用户
10926,2,3,3,4,2,2,8,潜力用户
10935,4,1,1,2,1,1,4,一般用户
10960,3,2,2,3,1,1,5,新用户
10968,3,1,1,3,1,1,5,新用户
10969,1,2,2,4,1,1,6,新用户
10983,4,1,1,2,1,1,4,一般用户
10984,0,2,2,4,1,1,6,新用户
10996,5,4,4,2,3,3,8,流失高价值用户
11016,3,2,2,3,1,1,5,新用户
11045,4,2,2,2,1,1,4,一般用户
11058,6,1,1,1,1,1,3,一般用户
11079,0,4,4,4,3,3,10,高价值用户
11096,4,1,1,2,1,1,4,一般用户
11097,6,1,1,1,1,1,3,一般用户
11099,1,3,3,4,2,2,8,潜力用户
11140,1,1,1,4,1,1,6,新用户
11145,3,5,5,3,3,3,9,高价值用户
11158,6,2,2,1,1,1,3,一般用户
11159,2,3,3,4,2,2,8,潜力用户
11162,0,2,2,4,1,1,6,新用户
11179,3,2,2,3,1,1,5,新用户
11189,1,1,1,4,1,1,6,新用户
11190,0,6,6,4,3,3,10,高价值用户
11194,2,3,3,4,2,2,8,潜力用户
11202,1,1,1,4,1,1,6,新用户
11215,2,1,1,4,1,1,6,新用户
11222,7,1,1,1,1,1,3,一般用户
11226,0,3,3,4,2,2,8,潜力用户
11246,0,1,1,4,1,1,6,新用户
11253,4,2,2,2,1,1,4,一般用户
11255,1,1,1,4,1,1,6,新用户
11272,0,3,3,4,2,2,8,潜力用户
11283,2,1,1,4,1,1,6,新用户
11294,0,4,4,4,3,3,10,高价值用户
11295,0,9,9,4,3,3,10,高价值用户
11304,6,1,1,1,1,1,3,一般用户
11327,6,1,1,1,1,1,3,一般用户
11341,0,2,2,4,1,1,6,新用户
11344,3,2,2,3,1,1,5,新用户
11345,2,2,2,4,1,1,6,新用户
11377,2,1,1,4,1,1,6,新用户
11379,7,4,4,1,3,3,7,流失高价值用户
11393,2,4,4,4,3,3,10,高价值用户
11403,0,5,5,4,3,3,10,高价值用户
11413,5,1,1,2,1,1,4,一般用户
11417,2,4,4,4,3,3,10,高价值用户
11435,4,3,3,2,2,2,6,一般用户
11450,6,2,2,1,1,1,3,一般用户
11452,0,1,1,4,1,1,6,新用户
11465,7,1,1,1,1,1,3,一般用户
11495,0,4,4,4,3,3,10,高价值用户
11497,5,2,2,2,1,1,4,一般用户
11498,1,3,3,4,2,2,8,潜力用户
11501,4,1,1,2,1,1,4,一般用户
11503,0,2,2,4,1,1,6,新用户
11504,5,7,7,2,3,3,8,流失高价值用户
11507,1,1,1,4,1,1,6,新用户
11509,0,2,2,4,1,1,6,新用户
11517,0,1,1,4,1,1,6,新用户
11524,0,1,1,4,1,1,6,新用户
11531,2,1,1,4,1,1,6,新用户
11540,7,1,1,1,1,1,3,一般用户
11552,3,3,3,3,2,2,7,潜力用户
11588,3,2,2,3,1,1,5,新用户
11590,1,1,1,4,1,1,6,新用户
11594,2,1,1,4,1,1,6,新用户
11601,7,1,1,1,1,1,3,一般用户
11610,3,3,3,3,2,2,7,潜力用户
11611,5,1,1,2,1,1,4,一般用户
11619,2,3,3,4,2,2,8,潜力用户
11663,7,1,1,1,1,1,3,一般用户
11666,5,1,1,2,1,1,4,一般用户
11682,1,3,3,4,2,2,8,潜力用户
11708,2,3,3,4,2,2,8,潜力用户
11714,1,6,6,4,3,3,10,高价值用户
11730,8,3,3,1,2,2,5,一般用户
11740,5,1,1,2,1,1,4,一般用户
11763,0,3,3,4,2,2,8,潜力用户
11770,5,1,1,2,1,1,4,一般用户
11774,5,2,2,2,1,1,4,一般用户
11783,2,1,1,4,1,1,6,新用户
11792,0,2,2,4,1,1,6,新用户
11800,6,1,1,1,1,1,3,一般用户
11812,0,1,1,4,1,1,6,新用户
11834,1,4,4,4,3,3,10,高价值用户
11835,3,1,1,3,1,1,5,新用户
11839,7,1,1,1,1,1,3,一般用户
11855,5,3,3,2,2,2,6,一般用户
11900,7,1,1,1,1,1,3,一般用户
11912,3,1,1,3,1,1,5,新用户
11923,3,1,1,3,1,1,5,新用户
11946,0,8,8,4,3,3,10,高价值用户
11950,0,1,1,4,1,1,6,新用户
11964,6,1,1,1,1,1,3,一般用户
11975,6,1,1,1,1,1,3,一般用户
11976,0,6,6,4,3,3,10,高价值用户
11988,8,1,1,1,1,1,3,一般用户
11995,7,1,1,1,1,1,3,一般用户
11998,8,3,3,1,2,2,5,一般用户
12004,1,2,2,4,1,1,6,新用户
12026,1,2,2,4,1,1,6,新用户
12035,1,10,10,4,3,3,10,高价值用户
12037,1,1,1,4,1,1,6,新用户
12050,3,1,1,3,1,1,5,新用户
12068,0,1,1,4,1,1,6,新用户
12078,1,2,2,4,1,1,6,新用户
12082,2,1,1,4,1,1,6,新用户
12084,8,1,1,1,1,1,3,一般用户
12087,4,2,2,2,1,1,4,一般用户
12088,5,1,1,2,1,1,4,一般用户
12095,4,2,2,2,1,1,4,一般用户
12099,2,1,1,4,1,1,6,新用户
12104,1,3,3,4,2,2,8,潜力用户
12105,4,1,1,2,1,1,4,一般用户
12112,0,3,3,4,2,2,8,潜力用户
12117,0,2,2,4,1,1,6,新用户
12124,1,3,3,4,2,2,8,潜力用户
12133,0,2,2,4,1,1,6,新用户
12143,4,2,2,2,1,1,4,一般用户
12151,7,5,5,1,3,3,7,流失高价值用户
12163,1,1,1,4,1,1,6,新用户
12169,6,3,3,1,2,2,5,一般用户
12178,8,1,1,1,1,1,3,一般用户
12180,2,1,1,4,1,1,6,新用户
12186,5,1,1,2,1,1,4,一般用户
12202,0,3,3,4,2,2,8,潜力用户
12213,0,3,3,4,2,2,8,潜力用户
12261,3,6,6,3,3,3,9,高价值用户
12265,2,1,1,4,1,1,6,新用户
12274,0,3,3,4,2,2,8,潜力用户
12289,1,1,1,4,1,1,6,新用户
12295,2,2,2,4,1,1,6,新用户
12308,4,1,1,2,1,1,4,一般用户
12322,1,3,3,4,2,2,8,潜力用户
12351,1,2,2,4,1,1,6,新用户
12356,5,1,1,2,1,1,4,一般用户
12360,0,1,1,4,1,1,6,新用户
12375,8,1,1,1,1,1,3,一般用户
12387,0,1,1,4,1,1,6,新用户
12412,0,1,1,4,1,1,6,新用户
12420,7,2,2,1,1,1,3,一般用户
12432,2,2,2,4,1,1,6,新用户
12455,1,1,1,4,1,1,6,新用户
12464,5,1,1,2,1,1,4,一般用户
12465,6,3,3,1,2,2,5,一般用户
12476,1,6,6,4,3,3,10,高价值用户
12482,2,2,2,4,1,1,6,新用户
12492,1,3,3,4,2,2,8,潜力用户
12500,0,1,1,4,1,1,6,新用户
12524,0,1,1,4,1,1,6,新用户
12566,4,1,1,2,1,1,4,一般用户
12569,2,2,2,4,1,1,6,新用户
12578,3,1,1,3,1,1,5,新用户
12605,0,2,2,4,1,1,6,新用户
12615,3,3,3,3,2,2,7,潜力用户
12629,2,1,1,4,1,1,6,新用户
12630,1,3,3,4,2,2,8,潜力用户
12644,0,3,3,4,2,2,8,潜力用户
12646,0,5,5,4,3,3,10,高价值用户
12650,4,1,1,2,1,1,4,一般用户
12665,3,2,2,3,1,1,5,新用户
12674,0,1,1,4,1,1,6,新用户
12699,8,1,1,1,1,1,3,一般用户
12701,0,8,8,4,3,3,10,高价值用户
12707,2,2,2,4,1,1,6,新用户
12709,3,1,1,3,1,1,5,新用户
12722,4,2,2,2,1,1,4,一般用户
12747,1,1,1,4,1,1,6,新用户
12756,1,5,5,4,3,3,10,高价值用户
12763,0,2,2,4,1,1,6,新用户
12764,8,1,1,1,1,1,3,一般用户
12775,6,2,2,1,1,1,3,一般用户
12779,4,1,1,2,1,1,4,一般用户
12780,7,1,1,1,1,1,3,一般用户
12801,1,14,14,4,3,3,10,高价值用户
12830,8,2,2,1,1,1,3,一般用户
12851,1,2,2,4,1,1,6,新用户
12860,3,3,3,3,2,2,7,潜力用户
100002,3,1,1,3,1,1,5,新用户
100009,1,1,1,4,1,1,6,新用户
100030,8,4,4,1,3,3,7,流失高价值用户
100068,3,3,3,3,2,2,7,潜力用户
100075,3,1,1,3,1,1,5,新用户
100088,7,1,1,1,1,1,3,一般用户
100101,3,6,6,3,3,3,9,高价值用户
100107,0,2,2,4,1,1,6,新用户
100113,4,1,1,2,1,1,4,一般用户
100128,1,1,1,4,1,1,6,新用户
100134,7,1,1,1,1,1,3,一般用户
100141,1,2,2,4,1,1,6,新用户
100164,4,1,1,2,1,1,4,一般用户
100173,2,4,4,4,3,3,10,高价值用户
100177,5,3,3,2,2,2,6,一般用户
100186,1,4,4,4,3,3,10,高价值用户
100191,2,3,3,4,2,2,8,潜力用户
100197,0,1,1,4,1,1,6,新用户
100204,5,3,3,2,2,2,6,一般用户
100215,1,3,3,4,2,2,8,潜力用户
100227,0,1,1,4,1,1,6,新用户
100234,5,5,5,2,3,3,8,流失高价值用户
100242,3,3,3,3,2,2,7,潜力用户
100243,0,2,2,4,1,1,6,新用户
100249,5,1,1,2,1,1,4,一般用户
100259,4,1,1,2,1,1,4,一般用户
100261,4,1,1,2,1,1,4,一般用户
100264,1,1,1,4,1,1,6,新用户
100279,0,2,2,4,1,1,6,新用户
100284,6,1,1,1,1,1,3,一般用户
100292,6,2,2,1,1,1,3,一般用户
100294,3,2,2,3,1,1,5,新用户
100308,5,1,1,2,1,1,4,一般用户
100318,0,1,1,4,1,1,6,新用户
100324,5,1,1,2,1,1,4,一般用户
100339,7,1,1,1,1,1,3,一般用户
100340,7,1,1,1,1,1,3,一般用户
100356,0,3,3,4,2,2,8,潜力用户
100357,1,2,2,4,1,1,6,新用户
100363,6,1,1,1,1,1,3,一般用户
100370,0,2,2,4,1,1,6,新用户
100377,0,2,2,4,1,1,6,新用户
100401,7,1,1,1,1,1,3,一般用户
100428,5,1,1,2,1,1,4,一般用户
100440,0,1,1,4,1,1,6,新用户
100451,4,1,1,2,1,1,4,一般用户
100477,4,1,1,2,1,1,4,一般用户
100483,1,2,2,4,1,1,6,新用户
100493,4,2,2,2,1,1,4,一般用户
100523,5,3,3,2,2,2,6,一般用户
100528,0,5,5,4,3,3,10,高价值用户
100540,3,2,2,3,1,1,5,新用户
100561,6,1,1,1,1,1,3,一般用户
100567,3,2,2,3,1,1,5,新用户
100580,4,6,6,2,3,3,8,流失高价值用户
100595,3,1,1,3,1,1,5,新用户
100599,0,2,2,4,1,1,6,新用户
100600,1,3,3,4,2,2,8,潜力用户
100614,3,1,1,3,1,1,5,新用户
100615,7,1,1,1,1,1,3,一般用户
100663,7,2,2,1,1,1,3,一般用户
100678,2,2,2,4,1,1,6,新用户
100688,8,1,1,1,1,1,3,一般用户
100700,7,1,1,1,1,1,3,一般用户
100712,4,1,1,2,1,1,4,一般用户
100719,7,1,1,1,1,1,3,一般用户
100734,1,2,2,4,1,1,6,新用户
100757,2,1,1,4,1,1,6,新用户
100760,6,3,3,1,2,2,5,一般用户
100762,2,2,2,4,1,1,6,新用户
100794,2,1,1,4,1,1,6,新用户
100797,1,5,5,4,3,3,10,高价值用户
100803,1,4,4,4,3,3,10,高价值用户
100814,0,2,2,4,1,1,6,新用户
100815,4,1,1,2,1,1,4,一般用户
100821,0,3,3,4,2,2,8,潜力用户
100860,2,2,2,4,1,1,6,新用户
100865,3,1,1,3,1,1,5,新用户
100871,1,3,3,4,2,2,8,潜力用户
100877,7,1,1,1,1,1,3,一般用户
100891,6,2,2,1,1,1,3,一般用户
100893,3,1,1,3,1,1,5,新用户
100901,2,1,1,4,1,1,6,新用户
100925,0,3,3,4,2,2,8,潜力用户
100977,7,3,3,1,2,2,5,一般用户
100992,4,1,1,2,1,1,4,一般用户
101003,5,1,1,2,1,1,4,一般用户
101008,0,6,6,4,3,3,10,高价值用户
101021,7,1,1,1,1,1,3,一般用户
101023,2,5,5,4,3,3,10,高价值用户
101024,5,2,2,2,1,1,4,一般用户
101033,2,2,2,4,1,1,6,新用户
101047,0,2,2,4,1,1,6,新用户
101058,4,1,1,2,1,1,4,一般用户
101082,1,6,6,4,3,3,10,高价值用户
101088,1,2,2,4,1,1,6,新用户
101096,3,4,4,3,3,3,9,高价值用户
101101,3,1,1,3,1,1,5,新用户
101104,6,1,1,1,1,1,3,一般用户
101114,1,1,1,4,1,1,6,新用户
101150,1,1,1,4,1,1,6,新用户
101165,1,2,2,4,1,1,6,新用户
101182,3,1,1,3,1,1,5,新用户
101188,6,7,7,1,3,3,7,流失高价值用户
101190,1,2,2,4,1,1,6,新用户
101210,5,1,1,2,1,1,4,一般用户
101212,2,2,2,4,1,1,6,新用户
101217,1,1,1,4,1,1,6,新用户
101231,4,1,1,2,1,1,4,一般用户
101239,0,3,3,4,2,2,8,潜力用户
101249,0,8,8,4,3,3,10,高价值用户
101269,0,1,1,4,1,1,6,新用户
101303,0,3,3,4,2,2,8,潜力用户
101305,4,2,2,2,1,1,4,一般用户
101306,2,2,2,4,1,1,6,新用户
101312,0,3,3,4,2,2,8,潜力用户
101319,3,1,1,3,1,1,5,新用户
101321,1,1,1,4,1,1,6,新用户
101339,2,1,1,4,1,1,6,新用户
101340,5,1,1,2,1,1,4,一般用户
101343,8,1,1,1,1,1,3,一般用户
101345,7,1,1,1,1,1,3,一般用户
101352,7,1,1,1,1,1,3,一般用户
101381,0,11,11,4,3,3,10,高价值用户
101391,4,2,2,2,1,1,4,一般用户
101392,1,3,3,4,2,2,8,潜力用户
101394,1,3,3,4,2,2,8,潜力用户
101402,3,1,1,3,1,1,5,新用户
101417,3,1,1,3,1,1,5,新用户
101420,0,6,6,4,3,3,10,高价值用户
101422,0,1,1,4,1,1,6,新用户
101431,3,1,1,3,1,1,5,新用户
101433,3,1,1,3,1,1,5,新用户
101434,1,1,1,4,1,1,6,新用户
101457,4,1,1,2,1,1,4,一般用户
101473,1,3,3,4,2,2,8,潜力用户
101489,0,1,1,4,1,1,6,新用户
101502,6,1,1,1,1,1,3,一般用户
101515,0,3,3,4,2,2,8,潜力用户
101516,3,1,1,3,1,1,5,新用户
101526,4,7,7,2,3,3,8,流失高价值用户
101527,0,2,2,4,1,1,6,新用户
101528,3,2,2,3,1,1,5,新用户
101583,2,2,2,4,1,1,6,新用户
101589,0,1,1,4,1,1,6,新用户
101640,0,3,3,4,2,2,8,潜力用户
101660,1,2,2,4,1,1,6,新用户
101661,1,1,1,4,1,1,6,新用户
101666,2,1,1,4,1,1,6,新用户
101673,7,1,1,1,1,1,3,一般用户
101674,8,1,1,1,1,1,3,一般用户
101678,7,1,1,1,1,1,3,一般用户
101733,6,1,1,1,1,1,3,一般用户
101738,8,2,2,1,1,1,3,一般用户
101744,5,2,2,2,1,1,4,一般用户
101771,1,3,3,4,2,2,8,潜力用户
101777,2,2,2,4,1,1,6,新用户
101797,8,1,1,1,1,1,3,一般用户
101808,5,1,1,2,1,1,4,一般用户
101817,5,3,3,2,2,2,6,一般用户
101832,1,16,16,4,3,3,10,高价值用户
101838,2,3,3,4,2,2,8,潜力用户
101855,1,2,2,4,1,1,6,新用户
101904,0,2,2,4,1,1,6,新用户
101907,4,1,1,2,1,1,4,一般用户
101909,0,1,1,4,1,1,6,新用户
101929,2,2,2,4,1,1,6,新用户
101947,8,1,1,1,1,1,3,一般用户
101954,4,1,1,2,1,1,4,一般用户
101982,5,1,1,2,1,1,4,一般用户
101983,7,1,1,1,1,1,3,一般用户
102019,4,4,4,2,3,3,8,流失高价值用户
102020,1,2,2,4,1,1,6,新用户
102034,7,4,4,1,3,3,7,流失高价值用户
102050,1,5,5,4,3,3,10,高价值用户
102069,3,2,2,3,1,1,5,新用户
102083,1,1,1,4,1,1,6,新用户
102088,4,1,1,2,1,1,4,一般用户
102101,1,1,1,4,1,1,6,新用户
102103,5,1,1,2,1,1,4,一般用户
102110,5,3,3,2,2,2,6,一般用户
102111,8,1,1,1,1,1,3,一般用户
102124,3,2,2,3,1,1,5,新用户
102126,1,2,2,4,1,1,6,新用户
102138,3,1,1,3,1,1,5,新用户
102159,2,1,1,4,1,1,6,新用户
102162,5,1,1,2,1,1,4,一般用户
102163,3,1,1,3,1,1,5,新用户
102184,5,1,1,2,1,1,4,一般用户
102189,7,1,1,1,1,1,3,一般用户
102220,4,5,5,2,3,3,8,流失高价值用户
102236,4,1,1,2,1,1,4,一般用户
102246,3,1,1,3,1,1,5,新用户
102248,2,2,2,4,1,1,6,新用户
102257,0,7,7,4,3,3,10,高价值用户
102260,8,1,1,1,1,1,3,一般用户
102270,1,2,2,4,1,1,6,新用户
102286,0,1,1,4,1,1,6,新用户
102302,1,3,3,4,2,2,8,潜力用户
102304,3,4,4,3,3,3,9,高价值用户
102307,4,1,1,2,1,1,4,一般用户
102308,7,1,1,1,1,1,3,一般用户
102315,2,1,1,4,1,1,6,新用户
102318,6,1,1,1,1,1,3,一般用户
102319,6,1,1,1,1,1,3,一般用户
102359,4,1,1,2,1,1,4,一般用户
102385,3,1,1,3,1,1,5,新用户
102386,0,5,5,4,3,3,10,高价值用户
102390,0,1,1,4,1,1,6,新用户
102391,0,1,1,4,1,1,6,新用户
102397,6,2,2,1,1,1,3,一般用户
102398,4,3,3,2,2,2,6,一般用户
102403,8,2,2,1,1,1,3,一般用户
102409,2,1,1,4,1,1,6,新用户
102422,2,1,1,4,1,1,6,新用户
102424,6,1,1,1,1,1,3,一般用户
102436,2,1,1,4,1,1,6,新用户
102450,4,1,1,2,1,1,4,一般用户
102481,1,3,3,4,2,2,8,潜力用户
102495,1,3,3,4,2,2,8,潜力用户
102496,8,1,1,1,1,1,3,一般用户
102509,2,1,1,4,1,1,6,新用户
102519,8,1,1,1,1,1,3,一般用户
102523,8,2,2,1,1,1,3,一般用户
102534,6,1,1,1,1,1,3,一般用户
102546,4,2,2,2,1,1,4,一般用户
102569,1,1,1,4,1,1,6,新用户
102574,0,4,4,4,3,3,10,高价值用户
102596,0,3,3,4,2,2,8,潜力用户
102609,3,1,1,3,1,1,5,新用户
102626,8,1,1,1,1,1,3,一般用户
102632,0,5,5,4,3,3,10,高价值用户
102633,1,6,6,4,3,3,10,高价值用户
102634,1,1,1,4,1,1,6,新用户
102642,3,1,1,3,1,1,5,新用户
102662,6,1,1,1,1,1,3,一般用户
102664,0,3,3,4,2,2,8,潜力用户
102682,1,3,3,4,2,2,8,潜力用户
102686,0,1,1,4,1,1,6,新用户
102690,6,1,1,1,1,1,3,一般用户
102697,7,1,1,1,1,1,3,一般用户
102703,0,4,4,4,3,3,10,高价值用户
102715,3,1,1,3,1,1,5,新用户
102716,3,8,8,3,3,3,9,高价值用户
102719,7,2,2,1,1,1,3,一般用户
102721,1,2,2,4,1,1,6,新用户
102728,1,3,3,4,2,2,8,潜力用户
102731,1,2,2,4,1,1,6,新用户
102750,1,2,2,4,1,1,6,新用户
102762,0,6,6,4,3,3,10,高价值用户
102768,1,1,1,4,1,1,6,新用户
102773,1,2,2,4,1,1,6,新用户
102774,0,3,3,4,2,2,8,潜力用户
102783,5,1,1,2,1,1,4,一般用户
102784,4,3,3,2,2,2,6,一般用户
102788,3,6,6,3,3,3,9,高价值用户
102795,1,2,2,4,1,1,6,新用户
102802,3,3,3,3,2,2,7,潜力用户
102856,0,1,1,4,1,1,6,新用户
102876,0,3,3,4,2,2,8,潜力用户
102885,2,1,1,4,1,1,6,新用户
102897,3,1,1,3,1,1,5,新用户
102903,2,1,1,4,1,1,6,新用户
102917,4,4,4,2,3,3,8,流失高价值用户
102930,5,2,2,2,1,1,4,一般用户
102932,3,3,3,3,2,2,7,潜力用户
102933,1,4,4,4,3,3,10,高价值用户
102945,6,1,1,1,1,1,3,一般用户
102953,0,22,22,4,3,3,10,高价值用户
102960,8,1,1,1,1,1,3,一般用户
102972,1,2,2,4,1,1,6,新用户
102976,4,1,1,2,1,1,4,一般用户
103001,4,2,2,2,1,1,4,一般用户
103004,0,1,1,4,1,1,6,新用户
103023,6,1,1,1,1,1,3,一般用户
103046,0,1,1,4,1,1,6,新用户
103054,5,1,1,2,1,1,4,一般用户
103062,4,2,2,2,1,1,4,一般用户
103067,6,1,1,1,1,1,3,一般用户
103071,2,4,4,4,3,3,10,高价值用户
103079,6,1,1,1,1,1,3,一般用户
103082,3,1,1,3,1,1,5,新用户
103084,0,1,1,4,1,1,6,新用户
103096,1,5,5,4,3,3,10,高价值用户
103112,2,1,1,4,1,1,6,新用户
103121,2,2,2,4,1,1,6,新用户
103128,1,1,1,4,1,1,6,新用户
103139,7,1,1,1,1,1,3,一般用户
103141,3,18,18,3,3,3,9,高价值用户
103146,3,3,3,3,2,2,7,潜力用户
103147,0,2,2,4,1,1,6,新用户
103151,6,1,1,1,1,1,3,一般用户
103153,1,9,9,4,3,3,10,高价值用户
103156,6,2,2,1,1,1,3,一般用户
103170,1,2,2,4,1,1,6,新用户
103175,3,1,1,3,1,1,5,新用户
103177,4,3,3,2,2,2,6,一般用户
103197,2,3,3,4,2,2,8,潜力用户
103202,2,1,1,4,1,1,6,新用户
103207,8,1,1,1,1,1,3,一般用户
103229,0,2,2,4,1,1,6,新用户
103242,5,6,6,2,3,3,8,流失高价值用户
103246,0,3,3,4,2,2,8,潜力用户
103259,7,1,1,1,1,1,3,一般用户
103260,4,1,1,2,1,1,4,一般用户
103303,1,4,4,4,3,3,10,高价值用户
103308,6,5,5,1,3,3,7,流失高价值用户
103312,5,2,2,2,1,1,4,一般用户
103313,4,1,1,2,1,1,4,一般用户
103367,8,1,1,1,1,1,3,一般用户
103373,1,2,2,4,1,1,6,新用户
103379,7,2,2,1,1,1,3,一般用户
103388,1,1,1,4,1,1,6,新用户
103395,1,1,1,4,1,1,6,新用户
103416,4,1,1,2,1,1,4,一般用户
103435,6,2,2,1,1,1,3,一般用户
103439,4,3,3,2,2,2,6,一般用户
103446,1,3,3,4,2,2,8,潜力用户
103448,1,2,2,4,1,1,6,新用户
103458,1,3,3,4,2,2,8,潜力用户
103463,5,3,3,2,2,2,6,一般用户
103469,3,1,1,3,1,1,5,新用户
103492,7,1,1,1,1,1,3,一般用户
103509,6,3,3,1,2,2,5,一般用户
103511,0,2,2,4,1,1,6,新用户
103530,0,1,1,4,1,1,6,新用户
103532,0,8,8,4,3,3,10,高价值用户
103538,3,1,1,3,1,1,5,新用户
103540,0,3,3,4,2,2,8,潜力用户
103543,8,1,1,1,1,1,3,一般用户
103552,4,1,1,2,1,1,4,一般用户
103582,0,1,1,4,1,1,6,新用户
103585,0,2,2,4,1,1,6,新用户
103623,3,2,2,3,1,1,5,新用户
103627,0,5,5,4,3,3,10,高价值用户
103628,0,1,1,4,1,1,6,新用户
103630,6,1,1,1,1,1,3,一般用户
103634,6,1,1,1,1,1,3,一般用户
103636,7,1,1,1,1,1,3,一般用户
103680,0,1,1,4,1,1,6,新用户
103704,2,1,1,4,1,1,6,新用户
103710,0,3,3,4,2,2,8,潜力用户
103712,5,2,2,2,1,1,4,一般用户
103733,0,1,1,4,1,1,6,新用户
103741,3,1,1,3,1,1,5,新用户
103756,1,1,1,4,1,1,6,新用户
103775,3,1,1,3,1,1,5,新用户
103777,0,1,1,4,1,1,6,新用户
103780,1,1,1,4,1,1,6,新用户
103790,4,1,1,2,1,1,4,一般用户
103803,3,1,1,3,1,1,5,新用户
103807,3,1,1,3,1,1,5,新用户
103810,1,2,2,4,1,1,6,新用户
103814,0,2,2,4,1,1,6,新用户
103817,5,2,2,2,1,1,4,一般用户
103834,1,1,1,4,1,1,6,新用户
103846,0,1,1,4,1,1,6,新用户
103852,1,3,3,4,2,2,8,潜力用户
103854,3,3,3,3,2,2,7,潜力用户
103884,4,3,3,2,2,2,6,一般用户
103895,1,1,1,4,1,1,6,新用户
103902,4,6,6,2,3,3,8,流失高价值用户
103904,8,1,1,1,1,1,3,一般用户
103914,0,1,1,4,1,1,6,新用户
103949,8,1,1,1,1,1,3,一般用户
103966,0,3,3,4,2,2,8,潜力用户
103983,8,2,2,1,1,1,3,一般用户
104005,5,1,1,2,1,1,4,一般用户
104010,2,4,4,4,3,3,10,高价值用户
104013,7,1,1,1,1,1,3,一般用户
104014,3,1,1,3,1,1,5,新用户
104019,0,2,2,4,1,1,6,新用户
104051,3,1,1,3,1,1,5,新用户
104053,1,2,2,4,1,1,6,新用户
104065,1,3,3,4,2,2,8,潜力用户
104066,2,3,3,4,2,2,8,潜力用户
104082,4,1,1,2,1,1,4,一般用户
104083,0,8,8,4,3,3,10,高价值用户
104088,6,2,2,1,1,1,3,一般用户
104098,1,2,2,4,1,1,6,新用户
104111,7,1,1,1,1,1,3,一般用户
104115,1,1,1,4,1,1,6,新用户
104130,0,2,2,4,1,1,6,新用户
104137,7,1,1,1,1,1,3,一般用户
104142,0,1,1,4,1,1,6,新用户
104166,2,5,5,4,3,3,10,高价值用户
104169,2,1,1,4,1,1,6,新用户
104174,3,1,1,3,1,1,5,新用户
104192,5,2,2,2,1,1,4,一般用户
104201,7,3,3,1,2,2,5,一般用户
104216,2,3,3,4,2,2,8,潜力用户
104241,5,2,2,2,1,1,4,一般用户
104252,4,1,1,2,1,1,4,一般用户
104264,3,2,2,3,1,1,5,新用户
104293,7,1,1,1,1,1,3,一般用户
104332,3,1,1,3,1,1,5,新用户
104334,1,2,2,4,1,1,6,新用户
104337,1,5,5,4,3,3,10,高价值用户
104338,8,2,2,1,1,1,3,一般用户
104346,0,1,1,4,1,1,6,新用户
104349,0,3,3,4,2,2,8,潜力用户
104356,0,3,3,4,2,2,8,潜力用户
104363,8,1,1,1,1,1,3,一般用户
104368,5,3,3,2,2,2,6,一般用户
104391,2,3,3,4,2,2,8,潜力用户
104398,3,1,1,3,1,1,5,新用户
104406,8,1,1,1,1,1,3,一般用户
104420,2,4,4,4,3,3,10,高价值用户
104423,0,1,1,4,1,1,6,新用户
104430,2,1,1,4,1,1,6,新用户
104432,1,1,1,4,1,1,6,新用户
104450,4,1,1,2,1,1,4,一般用户
104486,6,1,1,1,1,1,3,一般用户
104503,3,1,1,3,1,1,5,新用户
104521,1,1,1,4,1,1,6,新用户
104570,3,5,5,3,3,3,9,高价值用户
104587,3,1,1,3,1,1,5,新用户
104593,4,1,1,2,1,1,4,一般用户
104599,4,1,1,2,1,1,4,一般用户
104620,0,2,2,4,1,1,6,新用户
104622,1,1,1,4,1,1,6,新用户
104623,5,1,1,2,1,1,4,一般用户
104626,2,3,3,4,2,2,8,潜力用户
104640,0,1,1,4,1,1,6,新用户
104653,0,1,1,4,1,1,6,新用户
104659,6,2,2,1,1,1,3,一般用户
104667,7,1,1,1,1,1,3,一般用户
104674,5,1,1,2,1,1,4,一般用户
104675,8,3,3,1,2,2,5,一般用户
104691,1,3,3,4,2,2,8,潜力用户
104703,6,4,4,1,3,3,7,流失高价值用户
104710,0,4,4,4,3,3,10,高价值用户
104733,2,6,6,4,3,3,10,高价值用户
104742,2,2,2,4,1,1,6,新用户
104749,7,1,1,1,1,1,3,一般用户
104778,7,1,1,1,1,1,3,一般用户
104781,1,5,5,4,3,3,10,高价值用户
104783,7,1,1,1,1,1,3,一般用户
104785,4,2,2,2,1,1,4,一般用户
104796,5,2,2,2,1,1,4,一般用户
104807,3,1,1,3,1,1,5,新用户
104811,0,2,2,4,1,1,6,新用户
104820,4,3,3,2,2,2,6,一般用户
104823,3,3,3,3,2,2,7,潜力用户
104829,4,2,2,2,1,1,4,一般用户
104842,5,3,3,2,2,2,6,一般用户
104879,0,3,3,4,2,2,8,潜力用户
104880,4,1,1,2,1,1,4,一般用户
104893,0,4,4,4,3,3,10,高价值用户
104894,1,2,2,4,1,1,6,新用户
104899,5,2,2,2,1,1,4,一般用户
104906,0,2,2,4,1,1,6,新用户
104911,2,1,1,4,1,1,6,新用户
104915,6,1,1,1,1,1,3,一般用户
104930,3,5,5,3,3,3,9,高价值用户
104935,1,3,3,4,2,2,8,潜力用户
104936,3,3,3,3,2,2,7,潜力用户
104944,1,2,2,4,1,1,6,新用户
104958,4,1,1,2,1,1,4,一般用户
104965,5,1,1,2,1,1,4,一般用户
104991,3,1,1,3,1,1,5,新用户
104997,1,1,1,4,1,1,6,新用户
105000,0,2,2,4,1,1,6,新用户
105027,7,9,9,1,3,3,7,流失高价值用户
105029,5,1,1,2,1,1,4,一般用户
105043,1,1,1,4,1,1,6,新用户
105044,0,2,2,4,1,1,6,新用户
105050,4,1,1,2,1,1,4,一般用户
105054,5,6,6,2,3,3,8,流失高价值用户
105059,5,1,1,2,1,1,4,一般用户
105060,1,1,1,4,1,1,6,新用户
105081,8,1,1,1,1,1,3,一般用户
105116,6,5,5,1,3,3,7,流失高价值用户
105121,3,1,1,3,1,1,5,新用户
105140,1,2,2,4,1,1,6,新用户
105144,6,1,1,1,1,1,3,一般用户
105145,7,1,1,1,1,1,3,一般用户
105161,3,2,2,3,1,1,5,新用户
105171,5,2,2,2,1,1,4,一般用户
105190,2,1,1,4,1,1,6,新用户
105193,6,1,1,1,1,1,3,一般用户
105194,1,3,3,4,2,2,8,潜力用户
105198,4,1,1,2,1,1,4,一般用户
105199,8,1,1,1,1,1,3,一般用户
105204,2,4,4,4,3,3,10,高价值用户
105207,0,1,1,4,1,1,6,新用户
105222,0,2,2,4,1,1,6,新用户
105254,7,1,1,1,1,1,3,一般用户
105279,7,1,1,1,1,1,3,一般用户
105297,1,1,1,4,1,1,6,新用户
105307,7,1,1,1,1,1,3,一般用户
105330,7,1,1,1,1,1,3,一般用户
105341,6,1,1,1,1,1,3,一般用户
105342,5,2,2,2,1,1,4,一般用户
105360,1,6,6,4,3,3,10,高价值用户
105364,0,5,5,4,3,3,10,高价值用户
105392,1,1,1,4,1,1,6,新用户
105422,2,3,3,4,2,2,8,潜力用户
105433,1,1,1,4,1,1,6,新用户
105455,4,2,2,2,1,1,4,一般用户
105465,0,2,2,4,1,1,6,新用户
105475,6,1,1,1,1,1,3,一般用户
105489,4,1,1,2,1,1,4,一般用户
105495,3,3,3,3,2,2,7,潜力用户
105506,7,1,1,1,1,1,3,一般用户
105509,5,2,2,2,1,1,4,一般用户
105515,1,1,1,4,1,1,6,新用户
105516,2,3,3,4,2,2,8,潜力用户
105530,2,2,2,4,1,1,6,新用户
105540,0,5,5,4,3,3,10,高价值用户
105542,2,1,1,4,1,1,6,新用户
105546,3,1,1,3,1,1,5,新用户
105550,0,3,3,4,2,2,8,潜力用户
105553,8,1,1,1,1,1,3,一般用户
105561,1,1,1,4,1,1,6,新用户
105572,8,1,1,1,1,1,3,一般用户
105581,5,3,3,2,2,2,6,一般用户
105596,6,4,4,1,3,3,7,流失高价值用户
105605,8,2,2,1,1,1,3,一般用户
105616,0,1,1,4,1,1,6,新用户
105624,7,1,1,1,1,1,3,一般用户
105632,3,1,1,3,1,1,5,新用户
105643,2,2,2,4,1,1,6,新用户
105654,2,1,1,4,1,1,6,新用户
105673,5,2,2,2,1,1,4,一般用户
105675,3,2,2,3,1,1,5,新用户
105689,3,3,3,3,2,2,7,潜力用户
105712,2,2,2,4,1,1,6,新用户
105721,2,1,1,4,1,1,6,新用户
105729,7,1,1,1,1,1,3,一般用户
105738,2,1,1,4,1,1,6,新用户
105748,0,4,4,4,3,3,10,高价值用户
105757,3,2,2,3,1,1,5,新用户
105789,6,1,1,1,1,1,3,一般用户
105796,4,2,2,2,1,1,4,一般用户
105797,0,2,2,4,1,1,6,新用户
105819,0,4,4,4,3,3,10,高价值用户
105823,8,1,1,1,1,1,3,一般用户
105858,1,1,1,4,1,1,6,新用户
105861,0,1,1,4,1,1,6,新用户
105873,5,1,1,2,1,1,4,一般用户
105884,1,2,2,4,1,1,6,新用户
105886,3,1,1,3,1,1,5,新用户
105899,4,2,2,2,1,1,4,一般用户
105903,6,3,3,1,2,2,5,一般用户
105904,3,1,1,3,1,1,5,新用户
105907,0,4,4,4,3,3,10,高价值用户
105908,5,1,1,2,1,1,4,一般用户
105920,3,1,1,3,1,1,5,新用户
105944,6,1,1,1,1,1,3,一般用户
105949,0,1,1,4,1,1,6,新用户
105952,7,2,2,1,1,1,3,一般用户
105968,8,1,1,1,1,1,3,一般用户
105975,0,2,2,4,1,1,6,新用户
105983,1,1,1,4,1,1,6,新用户
105984,2,2,2,4,1,1,6,新用户
105989,2,1,1,4,1,1,6,新用户
105992,4,2,2,2,1,1,4,一般用户
106005,7,1,1,1,1,1,3,一般用户
106007,2,2,2,4,1,1,6,新用户
106024,0,2,2,4,1,1,6,新用户
106033,2,1,1,4,1,1,6,新用户
106051,2,1,1,4,1,1,6,新用户
106056,8,1,1,1,1,1,3,一般用户
106067,0,7,7,4,3,3,10,高价值用户
106077,0,2,2,4,1,1,6,新用户
106080,0,8,8,4,3,3,10,高价值用户
106084,7,2,2,1,1,1,3,一般用户
106090,2,1,1,4,1,1,6,新用户
106107,3,2,2,3,1,1,5,新用户
106118,0,6,6,4,3,3,10,高价值用户
106142,1,4,4,4,3,3,10,高价值用户
106144,0,1,1,4,1,1,6,新用户
106147,6,1,1,1,1,1,3,一般用户
106157,0,1,1,4,1,1,6,新用户
106189,3,4,4,3,3,3,9,高价值用户
106190,4,5,5,2,3,3,8,流失高价值用户
106199,8,1,1,1,1,1,3,一般用户
106200,0,1,1,4,1,1,6,新用户
106213,2,1,1,4,1,1,6,新用户
106216,3,1,1,3,1,1,5,新用户
106235,2,4,4,4,3,3,10,高价值用户
106252,7,1,1,1,1,1,3,一般用户
106255,6,2,2,1,1,1,3,一般用户
106260,2,2,2,4,1,1,6,新用户
106267,2,1,1,4,1,1,6,新用户
106276,0,1,1,4,1,1,6,新用户
106286,1,15,15,4,3,3,10,高价值用户
106303,1,1,1,4,1,1,6,新用户
106334,6,1,1,1,1,1,3,一般用户
106347,3,1,1,3,1,1,5,新用户
106353,2,1,1,4,1,1,6,新用户
106355,8,1,1,1,1,1,3,一般用户
106363,0,2,2,4,1,1,6,新用户
106364,6,2,2,1,1,1,3,一般用户
106382,3,2,2,3,1,1,5,新用户
106392,2,2,2,4,1,1,6,新用户
106395,0,4,4,4,3,3,10,高价值用户
106400,0,4,4,4,3,3,10,高价值用户
106413,0,2,2,4,1,1,6,新用户
106415,0,4,4,4,3,3,10,高价值用户
106416,1,1,1,4,1,1,6,新用户
106424,6,1,1,1,1,1,3,一般用户
106435,4,1,1,2,1,1,4,一般用户
106437,3,1,1,3,1,1,5,新用户
106457,0,1,1,4,1,1,6,新用户
106468,3,2,2,3,1,1,5,新用户
106478,2,1,1,4,1,1,6,新用户
106488,0,1,1,4,1,1,6,新用户
106489,5,2,2,2,1,1,4,一般用户
106507,0,1,1,4,1,1,6,新用户
106514,7,2,2,1,1,1,3,一般用户
106518,4,1,1,2,1,1,4,一般用户
106525,4,2,2,2,1,1,4,一般用户
106526,0,2,2,4,1,1,6,新用户
106531,2,4,4,4,3,3,10,高价值用户
106532,3,3,3,3,2,2,7,潜力用户
106549,1,3,3,4,2,2,8,潜力用户
106550,8,1,1,1,1,1,3,一般用户
106561,1,1,1,4,1,1,6,新用户
106566,5,1,1,2,1,1,4,一般用户
106573,5,3,3,2,2,2,6,一般用户
106596,3,4,4,3,3,3,9,高价值用户
106600,2,3,3,4,2,2,8,潜力用户
106603,2,8,8,4,3,3,10,高价值用户
106613,2,2,2,4,1,1,6,新用户
106617,3,3,3,3,2,2,7,潜力用户
106621,5,1,1,2,1,1,4,一般用户
106634,8,1,1,1,1,1,3,一般用户
106635,1,2,2,4,1,1,6,新用户
106640,2,2,2,4,1,1,6,新用户
106649,1,3,3,4,2,2,8,潜力用户
106663,2,3,3,4,2,2,8,潜力用户
106699,0,1,1,4,1,1,6,新用户
106701,4,1,1,2,1,1,4,一般用户
106723,0,1,1,4,1,1,6,新用户
106724,5,1,1,2,1,1,4,一般用户
106742,0,2,2,4,1,1,6,新用户
106749,3,3,3,3,2,2,7,潜力用户
106789,1,2,2,4,1,1,6,新用户
106790,1,1,1,4,1,1,6,新用户
106838,1,4,4,4,3,3,10,高价值用户
106848,0,1,1,4,1,1,6,新用户
106852,5,2,2,2,1,1,4,一般用户
106854,0,2,2,4,1,1,6,新用户
106858,5,2,2,2,1,1,4,一般用户
106860,2,1,1,4,1,1,6,新用户
106920,2,3,3,4,2,2,8,潜力用户
106925,0,1,1,4,1,1,6,新用户
106928,2,4,4,4,3,3,10,高价值用户
106940,1,3,3,4,2,2,8,潜力用户
106951,5,4,4,2,3,3,8,流失高价值用户
106952,0,1,1,4,1,1,6,新用户
106970,4,2,2,2,1,1,4,一般用户
106971,7,1,1,1,1,1,3,一般用户
106994,0,1,1,4,1,1,6,新用户
106997,1,1,1,4,1,1,6,新用户
107002,6,2,2,1,1,1,3,一般用户
107011,2,1,1,4,1,1,6,新用户
107025,0,10,10,4,3,3,10,高价值用户
107027,5,1,1,2,1,1,4,一般用户
107028,2,5,5,4,3,3,10,高价值用户
107029,1,1,1,4,1,1,6,新用户
107030,5,1,1,2,1,1,4,一般用户
107046,3,2,2,3,1,1,5,新用户
107064,3,1,1,3,1,1,5,新用户
107078,1,10,10,4,3,3,10,高价值用户
107104,0,1,1,4,1,1,6,新用户
107109,5,8,8,2,3,3,8,流失高价值用户
107125,8,2,2,1,1,1,3,一般用户
107126,2,2,2,4,1,1,6,新用户
107134,0,7,7,4,3,3,10,高价值用户
107159,3,3,3,3,2,2,7,潜力用户
107160,4,1,1,2,1,1,4,一般用户
107161,3,1,1,3,1,1,5,新用户
107168,4,3,3,2,2,2,6,一般用户
107179,4,1,1,2,1,1,4,一般用户
107181,1,6,6,4,3,3,10,高价值用户
107188,0,1,1,4,1,1,6,新用户
107191,6,1,1,1,1,1,3,一般用户
107195,3,2,2,3,1,1,5,新用户
107205,0,3,3,4,2,2,8,潜力用户
107233,1,5,5,4,3,3,10,高价值用户
107239,1,1,1,4,1,1,6,新用户
107260,1,1,1,4,1,1,6,新用户
107268,2,1,1,4,1,1,6,新用户
107293,0,2,2,4,1,1,6,新用户
107311,2,1,1,4,1,1,6,新用户
107313,8,1,1,1,1,1,3,一般用户
107318,4,4,4,2,3,3,8,流失高价值用户
107333,5,3,3,2,2,2,6,一般用户
107345,7,2,2,1,1,1,3,一般用户
107346,2,3,3,4,2,2,8,潜力用户
107353,4,1,1,2,1,1,4,一般用户
107388,4,3,3,2,2,2,6,一般用户
107393,7,1,1,1,1,1,3,一般用户
107398,0,1,1,4,1,1,6,新用户
107407,2,2,2,4,1,1,6,新用户
107408,5,2,2,2,1,1,4,一般用户
107427,1,1,1,4,1,1,6,新用户
107445,7,2,2,1,1,1,3,一般用户
107447,4,1,1,2,1,1,4,一般用户
107471,0,4,4,4,3,3,10,高价值用户
107488,0,1,1,4,1,1,6,新用户
107492,5,1,1,2,1,1,4,一般用户
107549,0,1,1,4,1,1,6,新用户
107565,5,2,2,2,1,1,4,一般用户
107569,1,5,5,4,3,3,10,高价值用户
107584,5,1,1,2,1,1,4,一般用户
107586,6,1,1,1,1,1,3,一般用户
107601,0,3,3,4,2,2,8,潜力用户
107606,0,14,14,4,3,3,10,高价值用户
107615,2,2,2,4,1,1,6,新用户
107627,2,1,1,4,1,1,6,新用户
107628,2,1,1,4,1,1,6,新用户
107633,4,1,1,2,1,1,4,一般用户
107656,5,1,1,2,1,1,4,一般用户
107665,0,2,2,4,1,1,6,新用户
107670,1,2,2,4,1,1,6,新用户
107679,3,2,2,3,1,1,5,新用户
107693,0,2,2,4,1,1,6,新用户
107699,0,2,2,4,1,1,6,新用户
107718,6,2,2,1,1,1,3,一般用户
107723,4,3,3,2,2,2,6,一般用户
107726,0,1,1,4,1,1,6,新用户
107740,3,1,1,3,1,1,5,新用户
107741,5,1,1,2,1,1,4,一般用户
107748,4,1,1,2,1,1,4,一般用户
107756,0,2,2,4,1,1,6,新用户
107797,2,1,1,4,1,1,6,新用户
107800,6,2,2,1,1,1,3,一般用户
107805,2,2,2,4,1,1,6,新用户
107817,1,3,3,4,2,2,8,潜力用户
107830,6,2,2,1,1,1,3,一般用户
107845,8,1,1,1,1,1,3,一般用户
107848,1,1,1,4,1,1,6,新用户
107850,0,4,4,4,3,3,10,高价值用户
107891,4,1,1,2,1,1,4,一般用户
107902,5,2,2,2,1,1,4,一般用户
107916,7,1,1,1,1,1,3,一般用户
107917,7,2,2,1,1,1,3,一般用户
107923,2,1,1,4,1,1,6,新用户
107932,0,10,10,4,3,3,10,高价值用户
107935,0,2,2,4,1,1,6,新用户
107937,5,1,1,2,1,1,4,一般用户
107945,6,1,1,1,1,1,3,一般用户
107961,0,5,5,4,3,3,10,高价值用户
107982,8,4,4,1,3,3,7,流失高价值用户
107985,7,1,1,1,1,1,3,一般用户
107989,1,4,4,4,3,3,10,高价值用户
107990,0,2,2,4,1,1,6,新用户
108015,7,2,2,1,1,1,3,一般用户
108025,0,6,6,4,3,3,10,高价值用户
108036,6,1,1,1,1,1,3,一般用户
108037,0,1,1,4,1,1,6,新用户
108038,0,2,2,4,1,1,6,新用户
108045,4,3,3,2,2,2,6,一般用户
108050,0,4,4,4,3,3,10,高价值用户
108060,8,1,1,1,1,1,3,一般用户
108077,5,1,1,2,1,1,4,一般用户
108090,2,1,1,4,1,1,6,新用户
108092,1,2,2,4,1,1,6,新用户
108102,0,3,3,4,2,2,8,潜力用户
108103,0,2,2,4,1,1,6,新用户
108105,3,1,1,3,1,1,5,新用户
108108,3,2,2,3,1,1,5,新用户
108140,3,3,3,3,2,2,7,潜力用户
108149,6,2,2,1,1,1,3,一般用户
108154,0,1,1,4,1,1,6,新用户
108161,3,1,1,3,1,1,5,新用户
108164,1,1,1,4,1,1,6,新用户
108179,3,1,1,3,1,1,5,新用户
108182,4,1,1,2,1,1,4,一般用户
108185,4,2,2,2,1,1,4,一般用户
108187,1,1,1,4,1,1,6,新用户
108206,1,2,2,4,1,1,6,新用户
108227,0,3,3,4,2,2,8,潜力用户
108233,4,2,2,2,1,1,4,一般用户
108237,5,2,2,2,1,1,4,一般用户
108248,2,2,2,4,1,1,6,新用户
108259,2,9,9,4,3,3,10,高价值用户
108265,2,2,2,4,1,1,6,新用户
108270,3,2,2,3,1,1,5,新用户
108274,2,1,1,4,1,1,6,新用户
108275,7,2,2,1,1,1,3,一般用户
108288,3,1,1,3,1,1,5,新用户
108294,7,1,1,1,1,1,3,一般用户
108302,0,1,1,4,1,1,6,新用户
108348,1,1,1,4,1,1,6,新用户
108354,2,3,3,4,2,2,8,潜力用户
108363,1,1,1,4,1,1,6,新用户
108364,1,4,4,4,3,3,10,高价值用户
108382,3,1,1,3,1,1,5,新用户
108390,2,2,2,4,1,1,6,新用户
108397,6,1,1,1,1,1,3,一般用户
108407,3,4,4,3,3,3,9,高价值用户
108417,6,2,2,1,1,1,3,一般用户
108425,5,2,2,2,1,1,4,一般用户
108442,4,1,1,2,1,1,4,一般用户
108449,5,4,4,2,3,3,8,流失高价值用户
108450,0,1,1,4,1,1,6,新用户
108457,0,4,4,4,3,3,10,高价值用户
108480,1,3,3,4,2,2,8,潜力用户
108484,7,1,1,1,1,1,3,一般用户
108491,6,1,1,1,1,1,3,一般用户
108510,6,1,1,1,1,1,3,一般用户
108519,0,1,1,4,1,1,6,新用户
108523,0,5,5,4,3,3,10,高价值用户
108526,1,3,3,4,2,2,8,潜力用户
108529,2,3,3,4,2,2,8,潜力用户
108541,4,1,1,2,1,1,4,一般用户
108546,2,1,1,4,1,1,6,新用户
108568,0,1,1,4,1,1,6,新用户
108588,0,1,1,4,1,1,6,新用户
108605,1,1,1,4,1,1,6,新用户
108607,3,2,2,3,1,1,5,新用户
108623,8,1,1,1,1,1,3,一般用户
108629,6,1,1,1,1,1,3,一般用户
108634,5,1,1,2,1,1,4,一般用户
108635,5,3,3,2,2,2,6,一般用户
108651,1,1,1,4,1,1,6,新用户
108666,3,2,2,3,1,1,5,新用户
108669,2,1,1,4,1,1,6,新用户
108670,5,1,1,2,1,1,4,一般用户
108672,6,2,2,1,1,1,3,一般用户
108676,2,1,1,4,1,1,6,新用户
108703,1,2,2,4,1,1,6,新用户
108755,2,5,5,4,3,3,10,高价值用户
108768,6,1,1,1,1,1,3,一般用户
108773,1,2,2,4,1,1,6,新用户
108799,0,2,2,4,1,1,6,新用户
108805,2,1,1,4,1,1,6,新用户
108809,2,3,3,4,2,2,8,潜力用户
108823,6,1,1,1,1,1,3,一般用户
108825,0,2,2,4,1,1,6,新用户
108842,0,2,2,4,1,1,6,新用户
108845,3,1,1,3,1,1,5,新用户
108865,3,4,4,3,3,3,9,高价值用户
108870,3,1,1,3,1,1,5,新用户
108882,5,1,1,2,1,1,4,一般用户
108883,5,1,1,2,1,1,4,一般用户
108906,4,1,1,2,1,1,4,一般用户
108910,5,2,2,2,1,1,4,一般用户
108918,8,1,1,1,1,1,3,一般用户
108967,0,3,3,4,2,2,8,潜力用户
108969,8,1,1,1,1,1,3,一般用户
108988,3,2,2,3,1,1,5,新用户
108996,8,4,4,1,3,3,7,流失高价值用户
108997,0,5,5,4,3,3,10,高价值用户
109004,4,3,3,2,2,2,6,一般用户
109018,4,1,1,2,1,1,4,一般用户
109022,4,1,1,2,1,1,4,一般用户
109038,3,2,2,3,1,1,5,新用户
109047,1,2,2,4,1,1,6,新用户
109065,5,1,1,2,1,1,4,一般用户
109085,0,1,1,4,1,1,6,新用户
109092,3,1,1,3,1,1,5,新用户
109095,4,2,2,2,1,1,4,一般用户
109098,7,2,2,1,1,1,3,一般用户
109100,8,1,1,1,1,1,3,一般用户
109109,2,2,2,4,1,1,6,新用户
109117,1,2,2,4,1,1,6,新用户
109124,0,2,2,4,1,1,6,新用户
109134,7,1,1,1,1,1,3,一般用户
109135,2,3,3,4,2,2,8,潜力用户
109157,1,3,3,4,2,2,8,潜力用户
109161,2,1,1,4,1,1,6,新用户
109163,3,2,2,3,1,1,5,新用户
109169,0,4,4,4,3,3,10,高价值用户
109188,4,3,3,2,2,2,6,一般用户
109210,0,2,2,4,1,1,6,新用户
109216,8,2,2,1,1,1,3,一般用户
109218,0,1,1,4,1,1,6,新用户
109233,1,4,4,4,3,3,10,高价值用户
109253,5,1,1,2,1,1,4,一般用户
109270,1,1,1,4,1,1,6,新用户
109275,6,1,1,1,1,1,3,一般用户
109276,0,1,1,4,1,1,6,新用户
109277,2,1,1,4,1,1,6,新用户
109284,8,1,1,1,1,1,3,一般用户
109291,0,5,5,4,3,3,10,高价值用户
109295,4,2,2,2,1,1,4,一般用户
109321,1,9,9,4,3,3,10,高价值用户
109328,4,1,1,2,1,1,4,一般用户
109337,1,4,4,4,3,3,10,高价值用户
109343,2,3,3,4,2,2,8,潜力用户
109350,1,1,1,4,1,1,6,新用户
109357,8,1,1,1,1,1,3,一般用户
109364,0,8,8,4,3,3,10,高价值用户
109371,3,1,1,3,1,1,5,新用户
109377,5,1,1,2,1,1,4,一般用户
109397,1,1,1,4,1,1,6,新用户
109401,0,2,2,4,1,1,6,新用户
109407,7,1,1,1,1,1,3,一般用户
109416,5,2,2,2,1,1,4,一般用户
109443,2,1,1,4,1,1,6,新用户
109444,0,1,1,4,1,1,6,新用户
109474,0,3,3,4,2,2,8,潜力用户
109491,3,1,1,3,1,1,5,新用户
109496,1,2,2,4,1,1,6,新用户
109523,0,1,1,4,1,1,6,新用户
109529,2,3,3,4,2,2,8,潜力用户
109540,4,1,1,2,1,1,4,一般用户
109570,1,1,1,4,1,1,6,新用户
109589,5,3,3,2,2,2,6,一般用户
109606,6,1,1,1,1,1,3,一般用户
109623,6,2,2,1,1,1,3,一般用户
109660,0,17,17,4,3,3,10,高价值用户
109661,1,2,2,4,1,1,6,新用户
109671,4,1,1,2,1,1,4,一般用户
109684,2,5,5,4,3,3,10,高价值用户
109711,1,1,1,4,1,1,6,新用户
109717,3,3,3,3,2,2,7,潜力用户
109728,1,3,3,4,2,2,8,潜力用户
109733,1,3,3,4,2,2,8,潜力用户
109756,4,2,2,2,1,1,4,一般用户
109776,2,2,2,4,1,1,6,新用户
109782,4,1,1,2,1,1,4,一般用户
109794,2,1,1,4,1,1,6,新用户
109810,7,1,1,1,1,1,3,一般用户
109830,0,1,1,4,1,1,6,新用户
109856,5,2,2,2,1,1,4,一般用户
109860,4,1,1,2,1,1,4,一般用户
109873,1,1,1,4,1,1,6,新用户
109880,3,1,1,3,1,1,5,新用户
109889,7,1,1,1,1,1,3,一般用户
109908,5,1,1,2,1,1,4,一般用户
109911,1,1,1,4,1,1,6,新用户
109919,5,3,3,2,2,2,6,一般用户
109926,1,1,1,4,1,1,6,新用户
109931,4,1,1,2,1,1,4,一般用户
109945,4,1,1,2,1,1,4,一般用户
109948,8,1,1,1,1,1,3,一般用户
109951,0,2,2,4,1,1,6,新用户
109957,4,2,2,2,1,1,4,一般用户
109967,8,1,1,1,1,1,3,一般用户
109968,6,1,1,1,1,1,3,一般用户
109971,0,5,5,4,3,3,10,高价值用户
109974,0,2,2,4,1,1,6,新用户
109975,4,1,1,2,1,1,4,一般用户
109976,2,3,3,4,2,2,8,潜力用户
109977,0,1,1,4,1,1,6,新用户
109983,0,3,3,4,2,2,8,潜力用户
109990,0,1,1,4,1,1,6,新用户
110003,4,4,4,2,3,3,8,流失高价值用户
110020,2,7,7,4,3,3,10,高价值用户
110029,0,10,10,4,3,3,10,高价值用户
110032,6,1,1,1,1,1,3,一般用户
110041,2,3,3,4,2,2,8,潜力用户
110056,1,4,4,4,3,3,10,高价值用户
110058,7,1,1,1,1,1,3,一般用户
110062,6,1,1,1,1,1,3,一般用户
110091,0,3,3,4,2,2,8,潜力用户
110092,1,1,1,4,1,1,6,新用户
110097,0,9,9,4,3,3,10,高价值用户
110116,0,1,1,4,1,1,6,新用户
110117,1,5,5,4,3,3,10,高价值用户
110118,1,1,1,4,1,1,6,新用户
110165,0,1,1,4,1,1,6,新用户
110173,1,1,1,4,1,1,6,新用户
110176,1,1,1,4,1,1,6,新用户
110179,1,1,1,4,1,1,6,新用户
110193,0,2,2,4,1,1,6,新用户
110195,3,2,2,3,1,1,5,新用户
110196,7,1,1,1,1,1,3,一般用户
110200,0,7,7,4,3,3,10,高价值用户
110207,6,1,1,1,1,1,3,一般用户
110245,7,5,5,1,3,3,7,流失高价值用户
110247,7,2,2,1,1,1,3,一般用户
110248,8,1,1,1,1,1,3,一般用户
110254,5,1,1,2,1,1,4,一般用户
110259,0,1,1,4,1,1,6,新用户
110271,2,4,4,4,3,3,10,高价值用户
110294,0,2,2,4,1,1,6,新用户
110303,5,1,1,2,1,1,4,一般用户
110311,2,5,5,4,3,3,10,高价值用户
110328,0,2,2,4,1,1,6,新用户
110336,1,4,4,4,3,3,10,高价值用户
110339,5,3,3,2,2,2,6,一般用户
110350,6,1,1,1,1,1,3,一般用户
110357,4,1,1,2,1,1,4,一般用户
110359,1,4,4,4,3,3,10,高价值用户
110360,3,2,2,3,1,1,5,新用户
110365,0,3,3,4,2,2,8,潜力用户
110373,0,1,1,4,1,1,6,新用户
110387,7,1,1,1,1,1,3,一般用户
110405,1,5,5,4,3,3,10,高价值用户
110431,6,1,1,1,1,1,3,一般用户
110455,3,3,3,3,2,2,7,潜力用户
110499,1,2,2,4,1,1,6,新用户
110505,1,2,2,4,1,1,6,新用户
110511,4,1,1,2,1,1,4,一般用户
110520,3,2,2,3,1,1,5,新用户
110531,1,2,2,4,1,1,6,新用户
110541,1,2,2,4,1,1,6,新用户
110549,2,3,3,4,2,2,8,潜力用户
110557,2,2,2,4,1,1,6,新用户
110588,8,1,1,1,1,1,3,一般用户
110597,2,2,2,4,1,1,6,新用户
110622,7,4,4,1,3,3,7,流失高价值用户
110624,5,1,1,2,1,1,4,一般用户
110633,2,1,1,4,1,1,6,新用户
110635,1,1,1,4,1,1,6,新用户
110652,2,2,2,4,1,1,6,新用户
110653,2,4,4,4,3,3,10,高价值用户
110661,4,1,1,2,1,1,4,一般用户
110679,6,1,1,1,1,1,3,一般用户
110681,8,1,1,1,1,1,3,一般用户
110686,6,2,2,1,1,1,3,一般用户
110694,1,9,9,4,3,3,10,高价值用户
110704,0,6,6,4,3,3,10,高价值用户
110707,1,3,3,4,2,2,8,潜力用户
110710,2,4,4,4,3,3,10,高价值用户
110715,3,1,1,3,1,1,5,新用户
110720,4,2,2,2,1,1,4,一般用户
110725,2,2,2,4,1,1,6,新用户
110776,3,2,2,3,1,1,5,新用户
110801,4,4,4,2,3,3,8,流失高价值用户
110802,5,2,2,2,1,1,4,一般用户
110804,4,2,2,2,1,1,4,一般用户
110818,1,2,2,4,1,1,6,新用户
110827,8,1,1,1,1,1,3,一般用户
110862,0,2,2,4,1,1,6,新用户
110872,4,1,1,2,1,1,4,一般用户
110873,4,4,4,2,3,3,8,流失高价值用户
110878,0,2,2,4,1,1,6,新用户
110881,3,1,1,3,1,1,5,新用户
110885,1,4,4,4,3,3,10,高价值用户
110904,4,3,3,2,2,2,6,一般用户
110924,1,3,3,4,2,2,8,潜力用户
110928,4,3,3,2,2,2,6,一般用户
110934,1,1,1,4,1,1,6,新用户
110956,1,3,3,4,2,2,8,潜力用户
110973,2,1,1,4,1,1,6,新用户
110976,1,2,2,4,1,1,6,新用户
110989,4,2,2,2,1,1,4,一般用户
111004,2,1,1,4,1,1,6,新用户
111015,6,1,1,1,1,1,3,一般用户
111023,0,3,3,4,2,2,8,潜力用户
111041,7,2,2,1,1,1,3,一般用户
111052,1,4,4,4,3,3,10,高价值用户
111063,8,1,1,1,1,1,3,一般用户
111068,0,2,2,4,1,1,6,新用户
111081,7,1,1,1,1,1,3,一般用户
111095,3,3,3,3,2,2,7,潜力用户
111097,6,2,2,1,1,1,3,一般用户
111102,1,1,1,4,1,1,6,新用户
111107,5,5,5,2,3,3,8,流失高价值用户
111124,4,1,1,2,1,1,4,一般用户
111132,1,1,1,4,1,1,6,新用户
111169,7,1,1,1,1,1,3,一般用户
111184,8,1,1,1,1,1,3,一般用户
111196,3,1,1,3,1,1,5,新用户
111200,0,2,2,4,1,1,6,新用户
111213,0,2,2,4,1,1,6,新用户
111216,0,2,2,4,1,1,6,新用户
111221,3,1,1,3,1,1,5,新用户
111226,0,3,3,4,2,2,8,潜力用户
111247,0,2,2,4,1,1,6,新用户
111262,2,2,2,4,1,1,6,新用户
111266,1,5,5,4,3,3,10,高价值用户
111268,6,1,1,1,1,1,3,一般用户
111270,1,6,6,4,3,3,10,高价值用户
111273,8,1,1,1,1,1,3,一般用户
111288,5,4,4,2,3,3,8,流失高价值用户
111306,1,2,2,4,1,1,6,新用户
111322,2,8,8,4,3,3,10,高价值用户
111342,0,2,2,4,1,1,6,新用户
111346,1,1,1,4,1,1,6,新用户
111349,2,3,3,4,2,2,8,潜力用户
111365,1,2,2,4,1,1,6,新用户
111369,0,1,1,4,1,1,6,新用户
111386,5,4,4,2,3,3,8,流失高价值用户
111387,0,1,1,4,1,1,6,新用户
111459,0,3,3,4,2,2,8,潜力用户
111467,2,3,3,4,2,2,8,潜力用户
111482,0,2,2,4,1,1,6,新用户
111492,1,2,2,4,1,1,6,新用户
111501,4,1,1,2,1,1,4,一般用户
111512,3,1,1,3,1,1,5,新用户
111517,0,1,1,4,1,1,6,新用户
111524,1,5,5,4,3,3,10,高价值用户
111542,5,1,1,2,1,1,4,一般用户
111549,1,3,3,4,2,2,8,潜力用户
111551,6,2,2,1,1,1,3,一般用户
111552,3,4,4,3,3,3,9,高价值用户
111556,0,2,2,4,1,1,6,新用户
111572,5,2,2,2,1,1,4,一般用户
111585,0,1,1,4,1,1,6,新用户
111616,5,1,1,2,1,1,4,一般用户
111626,3,3,3,3,2,2,7,潜力用户
111629,0,3,3,4,2,2,8,潜力用户
111643,4,2,2,2,1,1,4,一般用户
111647,3,1,1,3,1,1,5,新用户
111692,0,2,2,4,1,1,6,新用户
111700,7,1,1,1,1,1,3,一般用户
111711,4,2,2,2,1,1,4,一般用户
111727,1,2,2,4,1,1,6,新用户
111738,0,2,2,4,1,1,6,新用户
111755,3,1,1,3,1,1,5,新用户
111765,4,5,5,2,3,3,8,流失高价值用户
111770,8,2,2,1,1,1,3,一般用户
111811,5,3,3,2,2,2,6,一般用户
111820,3,3,3,3,2,2,7,潜力用户
111821,3,1,1,3,1,1,5,新用户
111823,1,1,1,4,1,1,6,新用户
111826,1,1,1,4,1,1,6,新用户
111841,1,1,1,4,1,1,6,新用户
111848,4,2,2,2,1,1,4,一般用户
111856,8,1,1,1,1,1,3,一般用户
111860,5,1,1,2,1,1,4,一般用户
111867,1,3,3,4,2,2,8,潜力用户
111890,0,1,1,4,1,1,6,新用户
111894,1,1,1,4,1,1,6,新用户
111908,4,1,1,2,1,1,4,一般用户
111932,5,4,4,2,3,3,8,流失高价值用户
111933,5,1,1,2,1,1,4,一般用户
111941,3,1,1,3,1,1,5,新用户
111942,3,4,4,3,3,3,9,高价值用户
111948,4,5,5,2,3,3,8,流失高价值用户
111952,1,1,1,4,1,1,6,新用户
111976,4,1,1,2,1,1,4,一般用户
111987,6,1,1,1,1,1,3,一般用户
112040,4,2,2,2,1,1,4,一般用户
112057,2,2,2,4,1,1,6,新用户
112058,4,1,1,2,1,1,4,一般用户
112070,0,3,3,4,2,2,8,潜力用户
112087,0,2,2,4,1,1,6,新用户
112092,5,1,1,2,1,1,4,一般用户
112094,0,1,1,4,1,1,6,新用户
112099,5,1,1,2,1,1,4,一般用户
112104,0,1,1,4,1,1,6,新用户
112108,3,1,1,3,1,1,5,新用户
112111,3,4,4,3,3,3,9,高价值用户
112141,1,1,1,4,1,1,6,新用户
112145,1,2,2,4,1,1,6,新用户
112160,4,1,1,2,1,1,4,一般用户
112165,2,2,2,4,1,1,6,新用户
112166,5,2,2,2,1,1,4,一般用户
112208,3,2,2,3,1,1,5,新用户
112220,0,2,2,4,1,1,6,新用户
112225,8,1,1,1,1,1,3,一般用户
112229,1,1,1,4,1,1,6,新用户
112242,1,1,1,4,1,1,6,新用户
112243,1,1,1,4,1,1,6,新用户
112253,0,1,1,4,1,1,6,新用户
112274,2,1,1,4,1,1,6,新用户
112285,1,1,1,4,1,1,6,新用户
112286,7,1,1,1,1,1,3,一般用户
112287,0,4,4,4,3,3,10,高价值用户
112296,4,2,2,2,1,1,4,一般用户
112316,6,1,1,1,1,1,3,一般用户
112369,0,3,3,4,2,2,8,潜力用户
112372,0,4,4,4,3,3,10,高价值用户
112393,0,1,1,4,1,1,6,新用户
112435,4,1,1,2,1,1,4,一般用户
112447,3,2,2,3,1,1,5,新用户
112456,1,3,3,4,2,2,8,潜力用户
112457,7,1,1,1,1,1,3,一般用户
112471,5,1,1,2,1,1,4,一般用户
112485,1,1,1,4,1,1,6,新用户
112503,2,4,4,4,3,3,10,高价值用户
112526,5,2,2,2,1,1,4,一般用户
112535,8,1,1,1,1,1,3,一般用户
112544,0,1,1,4,1,1,6,新用户
112555,8,1,1,1,1,1,3,一般用户
112558,0,3,3,4,2,2,8,潜力用户
112566,7,1,1,1,1,1,3,一般用户
112568,5,2,2,2,1,1,4,一般用户
112571,6,2,2,1,1,1,3,一般用户
112573,7,1,1,1,1,1,3,一般用户
112584,5,1,1,2,1,1,4,一般用户
112587,0,1,1,4,1,1,6,新用户
112597,3,13,13,3,3,3,9,高价值用户
112614,1,2,2,4,1,1,6,新用户
112621,6,1,1,1,1,1,3,一般用户
112630,2,2,2,4,1,1,6,新用户
112654,4,2,2,2,1,1,4,一般用户
112668,2,1,1,4,1,1,6,新用户
112676,5,2,2,2,1,1,4,一般用户
112677,7,2,2,1,1,1,3,一般用户
112684,5,3,3,2,2,2,6,一般用户
112689,4,1,1,2,1,1,4,一般用户
112691,2,1,1,4,1,1,6,新用户
112710,1,6,6,4,3,3,10,高价值用户
112713,7,3,3,1,2,2,5,一般用户
112717,3,14,14,3,3,3,9,高价值用户
112735,7,1,1,1,1,1,3,一般用户
112741,0,8,8,4,3,3,10,高价值用户
112768,3,2,2,3,1,1,5,新用户
112775,0,2,2,4,1,1,6,新用户
112799,0,2,2,4,1,1,6,新用户
112802,0,1,1,4,1,1,6,新用户
112804,7,1,1,1,1,1,3,一般用户
112829,0,2,2,4,1,1,6,新用户
112832,3,2,2,3,1,1,5,新用户
112841,2,1,1,4,1,1,6,新用户
112844,6,3,3,1,2,2,5,一般用户
112845,0,2,2,4,1,1,6,新用户
112855,4,1,1,2,1,1,4,一般用户
112864,5,3,3,2,2,2,6,一般用户
112867,3,2,2,3,1,1,5,新用户
112870,6,3,3,1,2,2,5,一般用户
112877,2,6,6,4,3,3,10,高价值用户
112887,1,4,4,4,3,3,10,高价值用户
112899,1,1,1,4,1,1,6,新用户
112910,7,1,1,1,1,1,3,一般用户
112914,3,1,1,3,1,1,5,新用户
112920,7,1,1,1,1,1,3,一般用户
112933,3,5,5,3,3,3,9,高价值用户
112934,2,5,5,4,3,3,10,高价值用户
112936,0,3,3,4,2,2,8,潜力用户
112952,8,1,1,1,1,1,3,一般用户
112961,1,3,3,4,2,2,8,潜力用户
112965,0,1,1,4,1,1,6,新用户
112970,0,7,7,4,3,3,10,高价值用户
112972,3,1,1,3,1,1,5,新用户
112981,0,2,2,4,1,1,6,新用户
112988,2,1,1,4,1,1,6,新用户
113014,4,1,1,2,1,1,4,一般用户
113023,3,1,1,3,1,1,5,新用户
113027,6,2,2,1,1,1,3,一般用户
113031,0,1,1,4,1,1,6,新用户
113034,3,2,2,3,1,1,5,新用户
113053,1,1,1,4,1,1,6,新用户
113059,4,2,2,2,1,1,4,一般用户
113069,1,2,2,4,1,1,6,新用户
113080,2,3,3,4,2,2,8,潜力用户
113111,1,4,4,4,3,3,10,高价值用户
113116,1,1,1,4,1,1,6,新用户
113118,5,1,1,2,1,1,4,一般用户
113143,1,1,1,4,1,1,6,新用户
113163,0,6,6,4,3,3,10,高价值用户
113164,6,7,7,1,3,3,7,流失高价值用户
113194,7,1,1,1,1,1,3,一般用户
113198,2,2,2,4,1,1,6,新用户
113221,3,1,1,3,1,1,5,新用户
113244,0,1,1,4,1,1,6,新用户
113253,3,3,3,3,2,2,7,潜力用户
113255,7,2,2,1,1,1,3,一般用户
113256,3,2,2,3,1,1,5,新用户
113269,1,3,3,4,2,2,8,潜力用户
113291,1,3,3,4,2,2,8,潜力用户
113321,0,5,5,4,3,3,10,高价值用户
113361,1,4,4,4,3,3,10,高价值用户
113371,2,4,4,4,3,3,10,高价值用户
113372,2,6,6,4,3,3,10,高价值用户
113375,3,3,3,3,2,2,7,潜力用户
113397,0,6,6,4,3,3,10,高价值用户
113401,0,1,1,4,1,1,6,新用户
113424,3,2,2,3,1,1,5,新用户
113446,2,6,6,4,3,3,10,高价值用户
113491,0,1,1,4,1,1,6,新用户
113512,2,3,3,4,2,2,8,潜力用户
113514,8,1,1,1,1,1,3,一般用户
113523,7,4,4,1,3,3,7,流失高价值用户
113526,6,1,1,1,1,1,3,一般用户
113564,0,2,2,4,1,1,6,新用户
113570,0,6,6,4,3,3,10,高价值用户
113571,6,6,6,1,3,3,7,流失高价值用户
113572,3,1,1,3,1,1,5,新用户
113584,6,4,4,1,3,3,7,流失高价值用户
113593,2,1,1,4,1,1,6,新用户
113617,3,5,5,3,3,3,9,高价值用户
113625,3,1,1,3,1,1,5,新用户
113627,0,4,4,4,3,3,10,高价值用户
113640,4,2,2,2,1,1,4,一般用户
113690,8,1,1,1,1,1,3,一般用户
113696,2,5,5,4,3,3,10,高价值用户
113701,3,5,5,3,3,3,9,高价值用户
113705,6,7,7,1,3,3,7,流失高价值用户
113709,2,1,1,4,1,1,6,新用户
113722,6,3,3,1,2,2,5,一般用户
113731,5,1,1,2,1,1,4,一般用户
113732,5,1,1,2,1,1,4,一般用户
113743,3,1,1,3,1,1,5,新用户
113748,8,1,1,1,1,1,3,一般用户
113749,0,2,2,4,1,1,6,新用户
113762,1,1,1,4,1,1,6,新用户
113768,8,1,1,1,1,1,3,一般用户
113823,1,4,4,4,3,3,10,高价值用户
113829,0,4,4,4,3,3,10,高价值用户
113834,1,3,3,4,2,2,8,潜力用户
113848,7,1,1,1,1,1,3,一般用户
113873,8,1,1,1,1,1,3,一般用户
113879,3,3,3,3,2,2,7,潜力用户
113890,8,2,2,1,1,1,3,一般用户
113896,1,5,5,4,3,3,10,高价值用户
113900,1,1,1,4,1,1,6,新用户
113910,1,1,1,4,1,1,6,新用户
113932,0,3,3,4,2,2,8,潜力用户
113936,4,1,1,2,1,1,4,一般用户
113938,0,3,3,4,2,2,8,潜力用户
113956,1,3,3,4,2,2,8,潜力用户
113968,2,1,1,4,1,1,6,新用户
113973,7,7,7,1,3,3,7,流失高价值用户
113983,1,1,1,4,1,1,6,新用户
113984,2,2,2,4,1,1,6,新用户
114002,1,2,2,4,1,1,6,新用户
114010,1,1,1,4,1,1,6,新用户
114031,5,2,2,2,1,1,4,一般用户
114035,0,2,2,4,1,1,6,新用户
114036,3,3,3,3,2,2,7,潜力用户
114040,1,1,1,4,1,1,6,新用户
114046,4,1,1,2,1,1,4,一般用户
114069,5,2,2,2,1,1,4,一般用户
114105,7,1,1,1,1,1,3,一般用户
114132,7,1,1,1,1,1,3,一般用户
114141,5,4,4,2,3,3,8,流失高价值用户
114142,2,2,2,4,1,1,6,新用户
114160,5,1,1,2,1,1,4,一般用户
114172,4,2,2,2,1,1,4,一般用户
114189,0,3,3,4,2,2,8,潜力用户
114197,4,1,1,2,1,1,4,一般用户
114208,4,1,1,2,1,1,4,一般用户
114209,4,1,1,2,1,1,4,一般用户
114219,4,2,2,2,1,1,4,一般用户
114220,8,1,1,1,1,1,3,一般用户
114224,5,1,1,2,1,1,4,一般用户
114229,3,5,5,3,3,3,9,高价值用户
114232,6,1,1,1,1,1,3,一般用户
114246,1,4,4,4,3,3,10,高价值用户
114252,5,1,1,2,1,1,4,一般用户
114278,5,1,1,2,1,1,4,一般用户
114280,6,1,1,1,1,1,3,一般用户
114295,0,1,1,4,1,1,6,新用户
114309,8,2,2,1,1,1,3,一般用户
114321,0,1,1,4,1,1,6,新用户
114341,1,1,1,4,1,1,6,新用户
114344,2,1,1,4,1,1,6,新用户
114361,7,1,1,1,1,1,3,一般用户
114365,0,2,2,4,1,1,6,新用户
114367,1,2,2,4,1,1,6,新用户
114375,3,6,6,3,3,3,9,高价值用户
114415,7,1,1,1,1,1,3,一般用户
114419,2,1,1,4,1,1,6,新用户
114436,5,1,1,2,1,1,4,一般用户
114438,2,1,1,4,1,1,6,新用户
114454,0,2,2,4,1,1,6,新用户
114457,8,1,1,1,1,1,3,一般用户
114459,2,1,1,4,1,1,6,新用户
114467,2,11,11,4,3,3,10,高价值用户
114478,4,3,3,2,2,2,6,一般用户
114523,0,1,1,4,1,1,6,新用户
114524,4,2,2,2,1,1,4,一般用户
114536,0,1,1,4,1,1,6,新用户
114546,4,5,5,2,3,3,8,流失高价值用户
114558,3,4,4,3,3,3,9,高价值用户
114565,4,2,2,2,1,1,4,一般用户
114569,8,1,1,1,1,1,3,一般用户
114571,8,1,1,1,1,1,3,一般用户
114576,2,1,1,4,1,1,6,新用户
114594,0,1,1,4,1,1,6,新用户
114601,4,4,4,2,3,3,8,流失高价值用户
114616,8,1,1,1,1,1,3,一般用户
114635,6,1,1,1,1,1,3,一般用户
114644,1,3,3,4,2,2,8,潜力用户
114650,1,1,1,4,1,1,6,新用户
114656,1,1,1,4,1,1,6,新用户
114664,2,1,1,4,1,1,6,新用户
114669,1,2,2,4,1,1,6,新用户
114672,4,8,8,2,3,3,8,流失高价值用户
114687,1,7,7,4,3,3,10,高价值用户
114714,7,1,1,1,1,1,3,一般用户
114744,1,1,1,4,1,1,6,新用户
114749,4,2,2,2,1,1,4,一般用户
114752,5,1,1,2,1,1,4,一般用户
114754,7,1,1,1,1,1,3,一般用户
114771,0,1,1,4,1,1,6,新用户
114779,1,1,1,4,1,1,6,新用户
114781,0,9,9,4,3,3,10,高价值用户
114798,6,2,2,1,1,1,3,一般用户
114805,0,1,1,4,1,1,6,新用户
114823,4,1,1,2,1,1,4,一般用户
114824,0,3,3,4,2,2,8,潜力用户
114848,0,1,1,4,1,1,6,新用户
114861,3,1,1,3,1,1,5,新用户
114864,0,2,2,4,1,1,6,新用户
114873,1,2,2,4,1,1,6,新用户
114892,5,2,2,2,1,1,4,一般用户
114900,8,2,2,1,1,1,3,一般用户
114912,1,2,2,4,1,1,6,新用户
114917,7,1,1,1,1,1,3,一般用户
114926,3,5,5,3,3,3,9,高价值用户
114927,2,1,1,4,1,1,6,新用户
114931,2,2,2,4,1,1,6,新用户
114941,3,5,5,3,3,3,9,高价值用户
114948,0,18,18,4,3,3,10,高价值用户
114954,1,4,4,4,3,3,10,高价值用户
114962,2,1,1,4,1,1,6,新用户
115009,4,1,1,2,1,1,4,一般用户
115031,0,5,5,4,3,3,10,高价值用户
115039,8,1,1,1,1,1,3,一般用户
115044,5,1,1,2,1,1,4,一般用户
115046,7,4,4,1,3,3,7,流失高价值用户
115047,3,3,3,3,2,2,7,潜力用户
115098,3,1,1,3,1,1,5,新用户
115104,0,1,1,4,1,1,6,新用户
115109,0,4,4,4,3,3,10,高价值用户
115147,3,1,1,3,1,1,5,新用户
115168,4,1,1,2,1,1,4,一般用户
115179,2,3,3,4,2,2,8,潜力用户
115185,7,2,2,1,1,1,3,一般用户
115197,0,3,3,4,2,2,8,潜力用户
115221,1,2,2,4,1,1,6,新用户
115222,1,1,1,4,1,1,6,新用户
115224,2,1,1,4,1,1,6,新用户
115238,7,1,1,1,1,1,3,一般用户
115242,0,2,2,4,1,1,6,新用户
115245,0,1,1,4,1,1,6,新用户
115247,0,3,3,4,2,2,8,潜力用户
115250,8,1,1,1,1,1,3,一般用户
115254,1,6,6,4,3,3,10,高价值用户
115274,8,1,1,1,1,1,3,一般用户
115281,2,1,1,4,1,1,6,新用户
115289,5,1,1,2,1,1,4,一般用户
115299,1,1,1,4,1,1,6,新用户
115320,8,1,1,1,1,1,3,一般用户
115327,3,1,1,3,1,1,5,新用户
115337,1,6,6,4,3,3,10,高价值用户
115344,1,1,1,4,1,1,6,新用户
115350,1,1,1,4,1,1,6,新用户
115374,8,1,1,1,1,1,3,一般用户
115376,1,1,1,4,1,1,6,新用户
115387,0,3,3,4,2,2,8,潜力用户
115411,1,8,8,4,3,3,10,高价值用户
115415,5,2,2,2,1,1,4,一般用户
115416,2,5,5,4,3,3,10,高价值用户
115424,0,2,2,4,1,1,6,新用户
115438,4,1,1,2,1,1,4,一般用户
115440,0,3,3,4,2,2,8,潜力用户
115442,3,1,1,3,1,1,5,新用户
115453,6,2,2,1,1,1,3,一般用户
115462,6,1,1,1,1,1,3,一般用户
115476,3,1,1,3,1,1,5,新用户
115506,5,4,4,2,3,3,8,流失高价值用户
115509,6,2,2,1,1,1,3,一般用户
115512,0,3,3,4,2,2,8,潜力用户
115530,1,2,2,4,1,1,6,新用户
115531,6,4,4,1,3,3,7,流失高价值用户
115543,8,1,1,1,1,1,3,一般用户
115555,3,1,1,3,1,1,5,新用户
115563,1,2,2,4,1,1,6,新用户
115596,1,2,2,4,1,1,6,新用户
115614,0,3,3,4,2,2,8,潜力用户
115618,5,2,2,2,1,1,4,一般用户
115638,6,1,1,1,1,1,3,一般用户
115648,2,2,2,4,1,1,6,新用户
115651,0,2,2,4,1,1,6,新用户
115686,2,1,1,4,1,1,6,新用户
115710,2,1,1,4,1,1,6,新用户
115718,7,1,1,1,1,1,3,一般用户
115730,1,3,3,4,2,2,8,潜力用户
115738,3,3,3,3,2,2,7,潜力用户
115749,4,1,1,2,1,1,4,一般用户
115752,0,4,4,4,3,3,10,高价值用户
115762,5,2,2,2,1,1,4,一般用户
115773,4,1,1,2,1,1,4,一般用户
115774,7,2,2,1,1,1,3,一般用户
115810,4,3,3,2,2,2,6,一般用户
115813,4,1,1,2,1,1,4,一般用户
115822,5,1,1,2,1,1,4,一般用户
115864,5,2,2,2,1,1,4,一般用户
115866,6,1,1,1,1,1,3,一般用户
115874,1,2,2,4,1,1,6,新用户
115880,3,2,2,3,1,1,5,新用户
115906,6,1,1,1,1,1,3,一般用户
115914,4,3,3,2,2,2,6,一般用户
115919,2,1,1,4,1,1,6,新用户
115932,4,6,6,2,3,3,8,流失高价值用户
115935,4,3,3,2,2,2,6,一般用户
115941,1,4,4,4,3,3,10,高价值用户
115950,0,1,1,4,1,1,6,新用户
115966,0,2,2,4,1,1,6,新用户
115967,8,1,1,1,1,1,3,一般用户
115972,5,1,1,2,1,1,4,一般用户
115983,7,1,1,1,1,1,3,一般用户
115989,8,1,1,1,1,1,3,一般用户
115994,0,1,1,4,1,1,6,新用户
115996,0,2,2,4,1,1,6,新用户
116018,4,2,2,2,1,1,4,一般用户
116019,2,1,1,4,1,1,6,新用户
116028,2,12,12,4,3,3,10,高价值用户
116102,6,2,2,1,1,1,3,一般用户
116108,0,8,8,4,3,3,10,高价值用户
116123,1,1,1,4,1,1,6,新用户
116132,0,5,5,4,3,3,10,高价值用户
116133,8,1,1,1,1,1,3,一般用户
116143,1,1,1,4,1,1,6,新用户
116155,0,1,1,4,1,1,6,新用户
116167,1,2,2,4,1,1,6,新用户
116201,8,1,1,1,1,1,3,一般用户
116204,5,1,1,2,1,1,4,一般用户
116229,0,1,1,4,1,1,6,新用户
116241,2,5,5,4,3,3,10,高价值用户
116262,4,7,7,2,3,3,8,流失高价值用户
116264,3,1,1,3,1,1,5,新用户
116269,5,1,1,2,1,1,4,一般用户
116271,2,1,1,4,1,1,6,新用户
116282,7,1,1,1,1,1,3,一般用户
116286,4,1,1,2,1,1,4,一般用户
116287,2,1,1,4,1,1,6,新用户
116290,5,1,1,2,1,1,4,一般用户
116308,0,1,1,4,1,1,6,新用户
116310,0,1,1,4,1,1,6,新用户
116327,4,2,2,2,1,1,4,一般用户
116328,5,1,1,2,1,1,4,一般用户
116333,2,2,2,4,1,1,6,新用户
116343,1,1,1,4,1,1,6,新用户
116344,0,3,3,4,2,2,8,潜力用户
116345,6,1,1,1,1,1,3,一般用户
116352,8,1,1,1,1,1,3,一般用户
116355,1,3,3,4,2,2,8,潜力用户
116363,0,2,2,4,1,1,6,新用户
116364,1,2,2,4,1,1,6,新用户
116381,6,1,1,1,1,1,3,一般用户
116387,7,1,1,1,1,1,3,一般用户
116405,1,4,4,4,3,3,10,高价值用户
116407,4,1,1,2,1,1,4,一般用户
116430,4,1,1,2,1,1,4,一般用户
116459,2,1,1,4,1,1,6,新用户
116469,2,1,1,4,1,1,6,新用户
116523,0,9,9,4,3,3,10,高价值用户
116530,7,1,1,1,1,1,3,一般用户
116550,4,1,1,2,1,1,4,一般用户
116554,2,2,2,4,1,1,6,新用户
116572,0,3,3,4,2,2,8,潜力用户
116582,0,5,5,4,3,3,10,高价值用户
116588,7,1,1,1,1,1,3,一般用户
116596,1,3,3,4,2,2,8,潜力用户
116607,4,1,1,2,1,1,4,一般用户
116608,7,1,1,1,1,1,3,一般用户
116617,1,1,1,4,1,1,6,新用户
116624,6,1,1,1,1,1,3,一般用户
116636,0,1,1,4,1,1,6,新用户
116647,0,1,1,4,1,1,6,新用户
116656,4,1,1,2,1,1,4,一般用户
116659,3,2,2,3,1,1,5,新用户
116666,2,1,1,4,1,1,6,新用户
116682,0,7,7,4,3,3,10,高价值用户
116693,5,1,1,2,1,1,4,一般用户
116701,3,1,1,3,1,1,5,新用户
116717,6,1,1,1,1,1,3,一般用户
116722,2,2,2,4,1,1,6,新用户
116736,5,1,1,2,1,1,4,一般用户
116760,2,2,2,4,1,1,6,新用户
116767,2,1,1,4,1,1,6,新用户
116769,0,5,5,4,3,3,10,高价值用户
116796,5,2,2,2,1,1,4,一般用户
116797,3,3,3,3,2,2,7,潜力用户
116801,0,6,6,4,3,3,10,高价值用户
116805,0,3,3,4,2,2,8,潜力用户
116809,5,1,1,2,1,1,4,一般用户
116812,6,1,1,1,1,1,3,一般用户
116820,4,5,5,2,3,3,8,流失高价值用户
116821,7,2,2,1,1,1,3,一般用户
116842,0,2,2,4,1,1,6,新用户
116843,7,1,1,1,1,1,3,一般用户
116859,1,1,1,4,1,1,6,新用户
116867,6,1,1,1,1,1,3,一般用户
116868,0,1,1,4,1,1,6,新用户
116869,8,1,1,1,1,1,3,一般用户
116885,6,1,1,1,1,1,3,一般用户
116892,6,1,1,1,1,1,3,一般用户
116894,1,7,7,4,3,3,10,高价值用户
116897,1,1,1,4,1,1,6,新用户
116901,2,1,1,4,1,1,6,新用户
116906,8,1,1,1,1,1,3,一般用户
116911,3,2,2,3,1,1,5,新用户
116930,6,5,5,1,3,3,7,流失高价值用户
116941,3,5,5,3,3,3,9,高价值用户
116963,1,1,1,4,1,1,6,新用户
117006,2,2,2,4,1,1,6,新用户
117009,5,1,1,2,1,1,4,一般用户
117013,0,5,5,4,3,3,10,高价值用户
117016,1,1,1,4,1,1,6,新用户
117019,0,4,4,4,3,3,10,高价值用户
117038,3,1,1,3,1,1,5,新用户
117041,1,2,2,4,1,1,6,新用户
117053,2,3,3,4,2,2,8,潜力用户
117075,0,4,4,4,3,3,10,高价值用户
117080,2,3,3,4,2,2,8,潜力用户
117085,7,2,2,1,1,1,3,一般用户
117090,2,2,2,4,1,1,6,新用户
117092,2,2,2,4,1,1,6,新用户
117115,5,2,2,2,1,1,4,一般用户
117117,4,1,1,2,1,1,4,一般用户
117146,1,3,3,4,2,2,8,潜力用户
117154,8,2,2,1,1,1,3,一般用户
117156,2,1,1,4,1,1,6,新用户
117163,0,2,2,4,1,1,6,新用户
117171,2,2,2,4,1,1,6,新用户
117174,0,5,5,4,3,3,10,高价值用户
117176,7,2,2,1,1,1,3,一般用户
117184,6,5,5,1,3,3,7,流失高价值用户
117190,2,1,1,4,1,1,6,新用户
117193,1,4,4,4,3,3,10,高价值用户
117198,6,1,1,1,1,1,3,一般用户
117200,6,3,3,1,2,2,5,一般用户
117202,0,1,1,4,1,1,6,新用户
117206,3,2,2,3,1,1,5,新用户
117226,0,2,2,4,1,1,6,新用户
117246,3,1,1,3,1,1,5,新用户
117255,3,1,1,3,1,1,5,新用户
117278,4,2,2,2,1,1,4,一般用户
117284,5,1,1,2,1,1,4,一般用户
117311,6,1,1,1,1,1,3,一般用户
117330,3,1,1,3,1,1,5,新用户
117336,2,1,1,4,1,1,6,新用户
117341,0,1,1,4,1,1,6,新用户
117347,3,2,2,3,1,1,5,新用户
117356,1,2,2,4,1,1,6,新用户
117404,4,1,1,2,1,1,4,一般用户
117410,5,1,1,2,1,1,4,一般用户
117418,0,4,4,4,3,3,10,高价值用户
117421,2,1,1,4,1,1,6,新用户
117439,1,3,3,4,2,2,8,潜力用户
117442,1,1,1,4,1,1,6,新用户
117448,3,4,4,3,3,3,9,高价值用户
117450,5,1,1,2,1,1,4,一般用户
117452,0,2,2,4,1,1,6,新用户
117453,5,2,2,2,1,1,4,一般用户
117455,2,6,6,4,3,3,10,高价值用户
117458,7,2,2,1,1,1,3,一般用户
117459,0,2,2,4,1,1,6,新用户
117462,3,5,5,3,3,3,9,高价值用户
117473,1,1,1,4,1,1,6,新用户
117476,2,1,1,4,1,1,6,新用户
117530,2,2,2,4,1,1,6,新用户
117534,0,1,1,4,1,1,6,新用户
117539,1,6,6,4,3,3,10,高价值用户
117540,6,2,2,1,1,1,3,一般用户
117556,0,1,1,4,1,1,6,新用户
117560,3,1,1,3,1,1,5,新用户
117570,2,4,4,4,3,3,10,高价值用户
117578,6,1,1,1,1,1,3,一般用户
117585,1,2,2,4,1,1,6,新用户
117606,2,3,3,4,2,2,8,潜力用户
117607,3,1,1,3,1,1,5,新用户
117616,0,4,4,4,3,3,10,高价值用户
117627,7,1,1,1,1,1,3,一般用户
117648,1,4,4,4,3,3,10,高价值用户
117653,4,5,5,2,3,3,8,流失高价值用户
117666,5,1,1,2,1,1,4,一般用户
117671,1,1,1,4,1,1,6,新用户
117679,1,1,1,4,1,1,6,新用户
117689,1,2,2,4,1,1,6,新用户
117691,6,1,1,1,1,1,3,一般用户
117692,0,1,1,4,1,1,6,新用户
117701,5,1,1,2,1,1,4,一般用户
117707,3,2,2,3,1,1,5,新用户
117718,4,4,4,2,3,3,8,流失高价值用户
117738,2,2,2,4,1,1,6,新用户
117761,6,2,2,1,1,1,3,一般用户
117767,7,1,1,1,1,1,3,一般用户
117770,5,1,1,2,1,1,4,一般用户
117772,1,2,2,4,1,1,6,新用户
117776,7,1,1,1,1,1,3,一般用户
117782,1,2,2,4,1,1,6,新用户
117798,1,2,2,4,1,1,6,新用户
117802,6,1,1,1,1,1,3,一般用户
117805,1,3,3,4,2,2,8,潜力用户
117808,5,1,1,2,1,1,4,一般用户
117818,3,2,2,3,1,1,5,新用户
117857,0,2,2,4,1,1,6,新用户
117883,4,2,2,2,1,1,4,一般用户
117886,7,1,1,1,1,1,3,一般用户
117888,0,1,1,4,1,1,6,新用户
117893,3,2,2,3,1,1,5,新用户
117895,6,2,2,1,1,1,3,一般用户
117921,1,1,1,4,1,1,6,新用户
117933,6,1,1,1,1,1,3,一般用户
117935,7,1,1,1,1,1,3,一般用户
117941,6,2,2,1,1,1,3,一般用户
117957,1,1,1,4,1,1,6,新用户
117962,7,3,3,1,2,2,5,一般用户
117965,1,3,3,4,2,2,8,潜力用户
117972,2,1,1,4,1,1,6,新用户
117983,1,1,1,4,1,1,6,新用户
117987,7,1,1,1,1,1,3,一般用户
117990,0,1,1,4,1,1,6,新用户
118021,1,4,4,4,3,3,10,高价值用户
118056,0,9,9,4,3,3,10,高价值用户
118059,4,2,2,2,1,1,4,一般用户
118079,1,4,4,4,3,3,10,高价值用户
118087,3,2,2,3,1,1,5,新用户
118099,3,1,1,3,1,1,5,新用户
118112,6,1,1,1,1,1,3,一般用户
118130,2,2,2,4,1,1,6,新用户
118136,8,2,2,1,1,1,3,一般用户
118147,0,1,1,4,1,1,6,新用户
118149,0,2,2,4,1,1,6,新用户
118200,6,1,1,1,1,1,3,一般用户
118202,0,3,3,4,2,2,8,潜力用户
118203,2,1,1,4,1,1,6,新用户
118217,2,1,1,4,1,1,6,新用户
118231,1,3,3,4,2,2,8,潜力用户
118237,1,4,4,4,3,3,10,高价值用户
118238,1,3,3,4,2,2,8,潜力用户
118242,7,1,1,1,1,1,3,一般用户
118293,4,1,1,2,1,1,4,一般用户
118302,2,1,1,4,1,1,6,新用户
118305,6,1,1,1,1,1,3,一般用户
118306,2,2,2,4,1,1,6,新用户
118313,5,1,1,2,1,1,4,一般用户
118321,4,3,3,2,2,2,6,一般用户
118328,4,1,1,2,1,1,4,一般用户
118383,5,1,1,2,1,1,4,一般用户
118384,1,3,3,4,2,2,8,潜力用户
118418,4,1,1,2,1,1,4,一般用户
118432,0,5,5,4,3,3,10,高价值用户
118441,7,2,2,1,1,1,3,一般用户
118446,7,1,1,1,1,1,3,一般用户
118459,3,1,1,3,1,1,5,新用户
118469,1,2,2,4,1,1,6,新用户
118477,7,1,1,1,1,1,3,一般用户
118494,1,1,1,4,1,1,6,新用户
118505,5,1,1,2,1,1,4,一般用户
118513,4,5,5,2,3,3,8,流失高价值用户
118538,3,1,1,3,1,1,5,新用户
118566,6,1,1,1,1,1,3,一般用户
118567,0,7,7,4,3,3,10,高价值用户
118576,5,1,1,2,1,1,4,一般用户
118581,2,2,2,4,1,1,6,新用户
118585,4,1,1,2,1,1,4,一般用户
118587,2,1,1,4,1,1,6,新用户
118604,0,1,1,4,1,1,6,新用户
118611,1,1,1,4,1,1,6,新用户
118614,2,2,2,4,1,1,6,新用户
118648,1,1,1,4,1,1,6,新用户
118652,4,2,2,2,1,1,4,一般用户
118671,6,4,4,1,3,3,7,流失高价值用户
118681,0,2,2,4,1,1,6,新用户
118691,2,1,1,4,1,1,6,新用户
118693,1,1,1,4,1,1,6,新用户
118705,0,1,1,4,1,1,6,新用户
118740,0,8,8,4,3,3,10,高价值用户
118750,3,1,1,3,1,1,5,新用户
118751,0,2,2,4,1,1,6,新用户
118779,1,1,1,4,1,1,6,新用户
118784,1,5,5,4,3,3,10,高价值用户
118796,1,3,3,4,2,2,8,潜力用户
118815,4,1,1,2,1,1,4,一般用户
118840,0,2,2,4,1,1,6,新用户
118847,3,1,1,3,1,1,5,新用户
118859,6,1,1,1,1,1,3,一般用户
118867,0,5,5,4,3,3,10,高价值用户
118870,4,2,2,2,1,1,4,一般用户
118916,4,1,1,2,1,1,4,一般用户
118918,2,2,2,4,1,1,6,新用户
118924,0,3,3,4,2,2,8,潜力用户
118933,7,3,3,1,2,2,5,一般用户
118938,4,1,1,2,1,1,4,一般用户
118939,4,1,1,2,1,1,4,一般用户
118940,2,2,2,4,1,1,6,新用户
118955,0,1,1,4,1,1,6,新用户
118956,5,1,1,2,1,1,4,一般用户
118963,4,1,1,2,1,1,4,一般用户
118965,2,1,1,4,1,1,6,新用户
118976,0,4,4,4,3,3,10,高价值用户
118978,4,1,1,2,1,1,4,一般用户
118982,2,9,9,4,3,3,10,高价值用户
118994,8,1,1,1,1,1,3,一般用户
118996,0,5,5,4,3,3,10,高价值用户
119004,0,2,2,4,1,1,6,新用户
119022,0,3,3,4,2,2,8,潜力用户
119032,1,1,1,4,1,1,6,新用户
119076,1,3,3,4,2,2,8,潜力用户
119082,3,1,1,3,1,1,5,新用户
119083,4,1,1,2,1,1,4,一般用户
119089,2,1,1,4,1,1,6,新用户
119120,3,1,1,3,1,1,5,新用户
119125,1,8,8,4,3,3,10,高价值用户
119128,2,4,4,4,3,3,10,高价值用户
119139,0,2,2,4,1,1,6,新用户
119147,2,1,1,4,1,1,6,新用户
119168,6,1,1,1,1,1,3,一般用户
119185,0,3,3,4,2,2,8,潜力用户
119188,4,4,4,2,3,3,8,流失高价值用户
119205,1,3,3,4,2,2,8,潜力用户
119209,3,1,1,3,1,1,5,新用户
119213,1,2,2,4,1,1,6,新用户
119242,8,1,1,1,1,1,3,一般用户
119259,4,1,1,2,1,1,4,一般用户
119261,0,2,2,4,1,1,6,新用户
119270,7,2,2,1,1,1,3,一般用户
119272,4,2,2,2,1,1,4,一般用户
119280,4,4,4,2,3,3,8,流失高价值用户
119297,2,2,2,4,1,1,6,新用户
119305,1,1,1,4,1,1,6,新用户
119318,1,2,2,4,1,1,6,新用户
119319,5,3,3,2,2,2,6,一般用户
119332,6,1,1,1,1,1,3,一般用户
119333,0,1,1,4,1,1,6,新用户
119343,5,4,4,2,3,3,8,流失高价值用户
119369,2,1,1,4,1,1,6,新用户
119379,1,4,4,4,3,3,10,高价值用户
119383,8,1,1,1,1,1,3,一般用户
119390,1,1,1,4,1,1,6,新用户
119392,1,3,3,4,2,2,8,潜力用户
119395,1,2,2,4,1,1,6,新用户
119403,3,1,1,3,1,1,5,新用户
119408,0,1,1,4,1,1,6,新用户
119410,2,3,3,4,2,2,8,潜力用户
119428,0,1,1,4,1,1,6,新用户
119443,0,3,3,4,2,2,8,潜力用户
119472,2,3,3,4,2,2,8,潜力用户
119481,1,2,2,4,1,1,6,新用户
119489,0,6,6,4,3,3,10,高价值用户
119496,2,5,5,4,3,3,10,高价值用户
119498,4,3,3,2,2,2,6,一般用户
119502,0,10,10,4,3,3,10,高价值用户
119509,4,3,3,2,2,2,6,一般用户
119516,2,3,3,4,2,2,8,潜力用户
119527,1,2,2,4,1,1,6,新用户
119534,1,2,2,4,1,1,6,新用户
119543,7,1,1,1,1,1,3,一般用户
119552,5,1,1,2,1,1,4,一般用户
119562,4,2,2,2,1,1,4,一般用户
119568,2,1,1,4,1,1,6,新用户
119582,6,4,4,1,3,3,7,流失高价值用户
119605,4,1,1,2,1,1,4,一般用户
119610,6,1,1,1,1,1,3,一般用户
119616,1,1,1,4,1,1,6,新用户
119654,3,1,1,3,1,1,5,新用户
119657,7,2,2,1,1,1,3,一般用户
119664,1,2,2,4,1,1,6,新用户
119668,1,6,6,4,3,3,10,高价值用户
119690,0,2,2,4,1,1,6,新用户
119735,1,2,2,4,1,1,6,新用户
119746,2,2,2,4,1,1,6,新用户
119758,5,4,4,2,3,3,8,流失高价值用户
119767,7,1,1,1,1,1,3,一般用户
119775,0,3,3,4,2,2,8,潜力用户
119820,6,2,2,1,1,1,3,一般用户
119831,0,1,1,4,1,1,6,新用户
119879,1,1,1,4,1,1,6,新用户
119880,3,1,1,3,1,1,5,新用户
119883,1,2,2,4,1,1,6,新用户
119915,0,2,2,4,1,1,6,新用户
119925,0,2,2,4,1,1,6,新用户
119940,3,1,1,3,1,1,5,新用户
119944,8,2,2,1,1,1,3,一般用户
119961,0,3,3,4,2,2,8,潜力用户
119970,6,1,1,1,1,1,3,一般用户
119991,3,1,1,3,1,1,5,新用户
119998,1,3,3,4,2,2,8,潜力用户
120009,4,2,2,2,1,1,4,一般用户
120026,3,1,1,3,1,1,5,新用户
120036,0,2,2,4,1,1,6,新用户
120038,6,1,1,1,1,1,3,一般用户
120047,3,1,1,3,1,1,5,新用户
120052,5,2,2,2,1,1,4,一般用户
120059,8,3,3,1,2,2,5,一般用户
120062,7,1,1,1,1,1,3,一般用户
120076,3,5,5,3,3,3,9,高价值用户
120089,2,1,1,4,1,1,6,新用户
120114,0,2,2,4,1,1,6,新用户
120118,3,1,1,3,1,1,5,新用户
120129,2,1,1,4,1,1,6,新用户
120135,2,2,2,4,1,1,6,新用户
120137,3,7,7,3,3,3,9,高价值用户
120201,7,2,2,1,1,1,3,一般用户
120228,1,3,3,4,2,2,8,潜力用户
120238,5,1,1,2,1,1,4,一般用户
120241,3,2,2,3,1,1,5,新用户
120267,4,1,1,2,1,1,4,一般用户
120269,0,1,1,4,1,1,6,新用户
120271,3,3,3,3,2,2,7,潜力用户
120295,0,2,2,4,1,1,6,新用户
120304,7,1,1,1,1,1,3,一般用户
120305,1,3,3,4,2,2,8,潜力用户
120315,1,5,5,4,3,3,10,高价值用户
120336,7,1,1,1,1,1,3,一般用户
120338,4,1,1,2,1,1,4,一般用户
120344,6,1,1,1,1,1,3,一般用户
120349,0,3,3,4,2,2,8,潜力用户
120374,2,4,4,4,3,3,10,高价值用户
120375,3,1,1,3,1,1,5,新用户
120379,1,7,7,4,3,3,10,高价值用户
120381,3,1,1,3,1,1,5,新用户
120396,0,3,3,4,2,2,8,潜力用户
120398,6,2,2,1,1,1,3,一般用户
120422,6,2,2,1,1,1,3,一般用户
120425,6,2,2,1,1,1,3,一般用户
120426,2,1,1,4,1,1,6,新用户
120444,8,2,2,1,1,1,3,一般用户
120448,1,4,4,4,3,3,10,高价值用户
120452,6,1,1,1,1,1,3,一般用户
120466,5,1,1,2,1,1,4,一般用户
120471,6,2,2,1,1,1,3,一般用户
120477,7,1,1,1,1,1,3,一般用户
120478,3,1,1,3,1,1,5,新用户
120493,2,4,4,4,3,3,10,高价值用户
120514,1,2,2,4,1,1,6,新用户
120524,6,2,2,1,1,1,3,一般用户
120528,3,7,7,3,3,3,9,高价值用户
120534,3,1,1,3,1,1,5,新用户
120563,3,1,1,3,1,1,5,新用户
120565,4,1,1,2,1,1,4,一般用户
120575,0,2,2,4,1,1,6,新用户
120581,1,4,4,4,3,3,10,高价值用户
120594,1,3,3,4,2,2,8,潜力用户
120604,4,2,2,2,1,1,4,一般用户
120615,3,1,1,3,1,1,5,新用户
120621,8,1,1,1,1,1,3,一般用户
120627,0,1,1,4,1,1,6,新用户
120640,2,1,1,4,1,1,6,新用户
120674,3,2,2,3,1,1,5,新用户
120675,5,2,2,2,1,1,4,一般用户
120710,3,3,3,3,2,2,7,潜力用户
120734,2,4,4,4,3,3,10,高价值用户
120760,8,1,1,1,1,1,3,一般用户
120765,6,1,1,1,1,1,3,一般用户
120781,5,4,4,2,3,3,8,流失高价值用户
120785,4,1,1,2,1,1,4,一般用户
120823,3,1,1,3,1,1,5,新用户
120830,0,2,2,4,1,1,6,新用户
120849,0,6,6,4,3,3,10,高价值用户
120851,1,1,1,4,1,1,6,新用户
120887,0,1,1,4,1,1,6,新用户
120891,5,1,1,2,1,1,4,一般用户
120900,7,2,2,1,1,1,3,一般用户
120910,7,1,1,1,1,1,3,一般用户
120929,1,4,4,4,3,3,10,高价值用户
120932,0,4,4,4,3,3,10,高价值用户
120943,7,1,1,1,1,1,3,一般用户
120958,8,1,1,1,1,1,3,一般用户
120968,0,1,1,4,1,1,6,新用户
120975,4,8,8,2,3,3,8,流失高价值用户
120977,7,2,2,1,1,1,3,一般用户
120988,1,2,2,4,1,1,6,新用户
120993,0,9,9,4,3,3,10,高价值用户
121006,0,1,1,4,1,1,6,新用户
121018,4,2,2,2,1,1,4,一般用户
121020,3,1,1,3,1,1,5,新用户
121021,3,3,3,3,2,2,7,潜力用户
121024,4,2,2,2,1,1,4,一般用户
121025,4,3,3,2,2,2,6,一般用户
121066,0,2,2,4,1,1,6,新用户
121070,1,5,5,4,3,3,10,高价值用户
121085,1,3,3,4,2,2,8,潜力用户
121102,0,2,2,4,1,1,6,新用户
121131,3,2,2,3,1,1,5,新用户
121132,5,1,1,2,1,1,4,一般用户
121133,0,2,2,4,1,1,6,新用户
121136,1,7,7,4,3,3,10,高价值用户
121137,7,1,1,1,1,1,3,一般用户
121156,5,1,1,2,1,1,4,一般用户
121182,0,3,3,4,2,2,8,潜力用户
121189,2,1,1,4,1,1,6,新用户
121194,3,1,1,3,1,1,5,新用户
121196,3,2,2,3,1,1,5,新用户
121198,7,1,1,1,1,1,3,一般用户
121204,4,2,2,2,1,1,4,一般用户
121206,1,1,1,4,1,1,6,新用户
121218,0,1,1,4,1,1,6,新用户
121219,0,4,4,4,3,3,10,高价值用户
121223,5,2,2,2,1,1,4,一般用户
121285,8,1,1,1,1,1,3,一般用户
121288,2,6,6,4,3,3,10,高价值用户
121321,1,1,1,4,1,1,6,新用户
121322,4,1,1,2,1,1,4,一般用户
121337,1,1,1,4,1,1,6,新用户
121366,7,1,1,1,1,1,3,一般用户
121373,2,1,1,4,1,1,6,新用户
121377,5,2,2,2,1,1,4,一般用户
121379,2,4,4,4,3,3,10,高价值用户
121389,0,6,6,4,3,3,10,高价值用户
121393,6,1,1,1,1,1,3,一般用户
121417,0,1,1,4,1,1,6,新用户
121423,6,3,3,1,2,2,5,一般用户
121425,4,2,2,2,1,1,4,一般用户
121434,4,2,2,2,1,1,4,一般用户
121445,8,1,1,1,1,1,3,一般用户
121471,4,4,4,2,3,3,8,流失高价值用户
121502,2,4,4,4,3,3,10,高价值用户
121507,8,2,2,1,1,1,3,一般用户
121510,4,1,1,2,1,1,4,一般用户
121515,0,5,5,4,3,3,10,高价值用户
121528,5,1,1,2,1,1,4,一般用户
121530,5,2,2,2,1,1,4,一般用户
121536,5,2,2,2,1,1,4,一般用户
121540,0,1,1,4,1,1,6,新用户
121563,1,1,1,4,1,1,6,新用户
121571,0,1,1,4,1,1,6,新用户
121575,2,5,5,4,3,3,10,高价值用户
121584,4,2,2,2,1,1,4,一般用户
121601,1,2,2,4,1,1,6,新用户
121605,1,2,2,4,1,1,6,新用户
121613,5,2,2,2,1,1,4,一般用户
121637,0,1,1,4,1,1,6,新用户
121669,2,1,1,4,1,1,6,新用户
121684,0,1,1,4,1,1,6,新用户
121711,5,2,2,2,1,1,4,一般用户
121724,3,4,4,3,3,3,9,高价值用户
121741,0,4,4,4,3,3,10,高价值用户
121747,3,2,2,3,1,1,5,新用户
121757,8,8,8,1,3,3,7,流失高价值用户
121773,5,3,3,2,2,2,6,一般用户
121777,3,2,2,3,1,1,5,新用户
121789,2,2,2,4,1,1,6,新用户
121798,1,1,1,4,1,1,6,新用户
121801,2,3,3,4,2,2,8,潜力用户
121810,3,2,2,3,1,1,5,新用户
121837,1,1,1,4,1,1,6,新用户
121843,1,2,2,4,1,1,6,新用户
121849,4,1,1,2,1,1,4,一般用户
121854,5,2,2,2,1,1,4,一般用户
121858,0,5,5,4,3,3,10,高价值用户
121877,1,5,5,4,3,3,10,高价值用户
121881,6,2,2,1,1,1,3,一般用户
121890,8,3,3,1,2,2,5,一般用户
121910,0,5,5,4,3,3,10,高价值用户
121929,6,1,1,1,1,1,3,一般用户
121937,1,2,2,4,1,1,6,新用户
121938,2,5,5,4,3,3,10,高价值用户
121941,8,1,1,1,1,1,3,一般用户
121948,7,1,1,1,1,1,3,一般用户
121955,3,1,1,3,1,1,5,新用户
121968,6,1,1,1,1,1,3,一般用户
121970,7,3,3,1,2,2,5,一般用户
121974,2,3,3,4,2,2,8,潜力用户
121975,1,3,3,4,2,2,8,潜力用户
121985,0,5,5,4,3,3,10,高价值用户
121986,2,3,3,4,2,2,8,潜力用户
122005,1,2,2,4,1,1,6,新用户
122020,0,1,1,4,1,1,6,新用户
122033,8,1,1,1,1,1,3,一般用户
122046,0,2,2,4,1,1,6,新用户
122066,6,1,1,1,1,1,3,一般用户
122074,7,4,4,1,3,3,7,流失高价值用户
122091,0,1,1,4,1,1,6,新用户
122103,7,1,1,1,1,1,3,一般用户
122105,7,1,1,1,1,1,3,一般用户
122115,0,1,1,4,1,1,6,新用户
122125,7,1,1,1,1,1,3,一般用户
122133,3,1,1,3,1,1,5,新用户
122162,0,3,3,4,2,2,8,潜力用户
122170,2,1,1,4,1,1,6,新用户
122172,6,2,2,1,1,1,3,一般用户
122177,0,3,3,4,2,2,8,潜力用户
122211,6,1,1,1,1,1,3,一般用户
122214,1,2,2,4,1,1,6,新用户
122228,2,1,1,4,1,1,6,新用户
122232,3,3,3,3,2,2,7,潜力用户
122253,0,4,4,4,3,3,10,高价值用户
122264,0,3,3,4,2,2,8,潜力用户
122265,0,2,2,4,1,1,6,新用户
122272,2,5,5,4,3,3,10,高价值用户
122276,1,1,1,4,1,1,6,新用户
122277,2,5,5,4,3,3,10,高价值用户
122286,4,4,4,2,3,3,8,流失高价值用户
122292,7,1,1,1,1,1,3,一般用户
122293,4,5,5,2,3,3,8,流失高价值用户
122308,0,2,2,4,1,1,6,新用户
122309,2,1,1,4,1,1,6,新用户
122311,2,2,2,4,1,1,6,新用户
122323,7,2,2,1,1,1,3,一般用户
122333,1,2,2,4,1,1,6,新用户
122335,5,1,1,2,1,1,4,一般用户
122338,3,1,1,3,1,1,5,新用户
122341,5,4,4,2,3,3,8,流失高价值用户
122369,0,3,3,4,2,2,8,潜力用户
122379,1,2,2,4,1,1,6,新用户
122383,1,4,4,4,3,3,10,高价值用户
122389,0,4,4,4,3,3,10,高价值用户
122393,2,5,5,4,3,3,10,高价值用户
122397,4,3,3,2,2,2,6,一般用户
122403,7,3,3,1,2,2,5,一般用户
122405,8,1,1,1,1,1,3,一般用户
122410,2,7,7,4,3,3,10,高价值用户
122413,2,4,4,4,3,3,10,高价值用户
122423,1,8,8,4,3,3,10,高价值用户
122448,0,2,2,4,1,1,6,新用户
122470,4,1,1,2,1,1,4,一般用户
122471,2,2,2,4,1,1,6,新用户
122477,4,1,1,2,1,1,4,一般用户
122485,0,2,2,4,1,1,6,新用户
122492,0,2,2,4,1,1,6,新用户
122497,0,2,2,4,1,1,6,新用户
122502,5,1,1,2,1,1,4,一般用户
122503,2,2,2,4,1,1,6,新用户
122504,0,6,6,4,3,3,10,高价值用户
122545,6,1,1,1,1,1,3,一般用户
122558,2,4,4,4,3,3,10,高价值用户
122563,5,3,3,2,2,2,6,一般用户
122573,0,1,1,4,1,1,6,新用户
122574,1,1,1,4,1,1,6,新用户
122607,0,3,3,4,2,2,8,潜力用户
122616,1,4,4,4,3,3,10,高价值用户
122619,0,1,1,4,1,1,6,新用户
122634,2,3,3,4,2,2,8,潜力用户
122664,6,1,1,1,1,1,3,一般用户
122689,2,1,1,4,1,1,6,新用户
122691,6,2,2,1,1,1,3,一般用户
122706,0,1,1,4,1,1,6,新用户
122723,0,1,1,4,1,1,6,新用户
122729,6,1,1,1,1,1,3,一般用户
122735,1,2,2,4,1,1,6,新用户
122771,5,2,2,2,1,1,4,一般用户
122782,6,3,3,1,2,2,5,一般用户
122801,7,1,1,1,1,1,3,一般用户
122824,0,1,1,4,1,1,6,新用户
122852,5,5,5,2,3,3,8,流失高价值用户
122853,2,2,2,4,1,1,6,新用户
122855,2,2,2,4,1,1,6,新用户
122862,0,1,1,4,1,1,6,新用户
122864,5,2,2,2,1,1,4,一般用户
122871,3,5,5,3,3,3,9,高价值用户
122893,0,1,1,4,1,1,6,新用户
122901,1,1,1,4,1,1,6,新用户
122910,2,3,3,4,2,2,8,潜力用户
122911,4,1,1,2,1,1,4,一般用户
122917,3,1,1,3,1,1,5,新用户
122919,5,9,9,2,3,3,8,流失高价值用户
122929,2,1,1,4,1,1,6,新用户
122935,1,1,1,4,1,1,6,新用户
122976,0,2,2,4,1,1,6,新用户
122981,0,3,3,4,2,2,8,潜力用户
122985,1,1,1,4,1,1,6,新用户
122993,4,1,1,2,1,1,4,一般用户
123000,7,1,1,1,1,1,3,一般用户
123014,2,1,1,4,1,1,6,新用户
123020,2,1,1,4,1,1,6,新用户
123028,1,2,2,4,1,1,6,新用户
123035,0,1,1,4,1,1,6,新用户
123036,5,1,1,2,1,1,4,一般用户
123057,2,3,3,4,2,2,8,潜力用户
123076,8,1,1,1,1,1,3,一般用户
123084,4,5,5,2,3,3,8,流失高价值用户
123090,6,5,5,1,3,3,7,流失高价值用户
123108,8,1,1,1,1,1,3,一般用户
123109,0,1,1,4,1,1,6,新用户
123111,6,4,4,1,3,3,7,流失高价值用户
123123,7,1,1,1,1,1,3,一般用户
123131,3,1,1,3,1,1,5,新用户
123132,1,3,3,4,2,2,8,潜力用户
123145,4,1,1,2,1,1,4,一般用户
123150,3,1,1,3,1,1,5,新用户
123151,8,1,1,1,1,1,3,一般用户
123156,3,2,2,3,1,1,5,新用户
123172,5,1,1,2,1,1,4,一般用户
123178,0,1,1,4,1,1,6,新用户
123192,0,1,1,4,1,1,6,新用户
123194,2,2,2,4,1,1,6,新用户
123213,4,2,2,2,1,1,4,一般用户
123217,4,1,1,2,1,1,4,一般用户
123222,1,4,4,4,3,3,10,高价值用户
123242,2,3,3,4,2,2,8,潜力用户
123243,8,1,1,1,1,1,3,一般用户
123245,3,2,2,3,1,1,5,新用户
123246,3,3,3,3,2,2,7,潜力用户
123252,0,2,2,4,1,1,6,新用户
123264,1,2,2,4,1,1,6,新用户
123272,5,1,1,2,1,1,4,一般用户
123275,5,1,1,2,1,1,4,一般用户
123286,0,6,6,4,3,3,10,高价值用户
123301,4,2,2,2,1,1,4,一般用户
123302,4,2,2,2,1,1,4,一般用户
123312,0,2,2,4,1,1,6,新用户
123313,0,1,1,4,1,1,6,新用户
123316,0,2,2,4,1,1,6,新用户
123317,0,1,1,4,1,1,6,新用户
123325,3,1,1,3,1,1,5,新用户
123344,5,2,2,2,1,1,4,一般用户
123347,7,1,1,1,1,1,3,一般用户
123348,2,1,1,4,1,1,6,新用户
123350,2,1,1,4,1,1,6,新用户
123388,4,1,1,2,1,1,4,一般用户
123400,6,1,1,1,1,1,3,一般用户
123403,1,2,2,4,1,1,6,新用户
123433,8,1,1,1,1,1,3,一般用户
123493,8,3,3,1,2,2,5,一般用户
123521,6,2,2,1,1,1,3,一般用户
123525,2,2,2,4,1,1,6,新用户
123530,1,1,1,4,1,1,6,新用户
123539,7,1,1,1,1,1,3,一般用户
123541,7,1,1,1,1,1,3,一般用户
123543,5,3,3,2,2,2,6,一般用户
123553,0,1,1,4,1,1,6,新用户
123563,2,1,1,4,1,1,6,新用户
123579,2,2,2,4,1,1,6,新用户
123584,8,1,1,1,1,1,3,一般用户
123585,4,6,6,2,3,3,8,流失高价值用户
123603,4,1,1,2,1,1,4,一般用户
123608,5,3,3,2,2,2,6,一般用户
123635,1,3,3,4,2,2,8,潜力用户
123672,0,4,4,4,3,3,10,高价值用户
123694,0,4,4,4,3,3,10,高价值用户
123714,1,15,15,4,3,3,10,高价值用户
123748,7,1,1,1,1,1,3,一般用户
123755,0,10,10,4,3,3,10,高价值用户
123756,0,1,1,4,1,1,6,新用户
123762,0,3,3,4,2,2,8,潜力用户
123771,6,1,1,1,1,1,3,一般用户
123780,2,2,2,4,1,1,6,新用户
123793,6,2,2,1,1,1,3,一般用户
123803,3,1,1,3,1,1,5,新用户
123812,5,3,3,2,2,2,6,一般用户
123841,3,1,1,3,1,1,5,新用户
123866,6,2,2,1,1,1,3,一般用户
123871,1,4,4,4,3,3,10,高价值用户
123887,0,2,2,4,1,1,6,新用户
123888,1,2,2,4,1,1,6,新用户
123892,0,6,6,4,3,3,10,高价值用户
123897,1,1,1,4,1,1,6,新用户
123921,6,1,1,1,1,1,3,一般用户
123924,1,1,1,4,1,1,6,新用户
123933,6,1,1,1,1,1,3,一般用户
123938,7,2,2,1,1,1,3,一般用户
123942,2,1,1,4,1,1,6,新用户
123949,1,1,1,4,1,1,6,新用户
123962,2,7,7,4,3,3,10,高价值用户
123968,1,1,1,4,1,1,6,新用户
123971,1,3,3,4,2,2,8,潜力用户
123978,7,1,1,1,1,1,3,一般用户
123992,4,1,1,2,1,1,4,一般用户
124001,3,4,4,3,3,3,9,高价值用户
124006,4,1,1,2,1,1,4,一般用户
124010,6,2,2,1,1,1,3,一般用户
124025,5,1,1,2,1,1,4,一般用户
124033,1,4,4,4,3,3,10,高价值用户
124036,0,2,2,4,1,1,6,新用户
124061,7,1,1,1,1,1,3,一般用户
124065,1,1,1,4,1,1,6,新用户
124069,3,2,2,3,1,1,5,新用户
124072,5,2,2,2,1,1,4,一般用户
124079,4,1,1,2,1,1,4,一般用户
124083,3,3,3,3,2,2,7,潜力用户
124093,6,1,1,1,1,1,3,一般用户
124095,0,8,8,4,3,3,10,高价值用户
124101,0,2,2,4,1,1,6,新用户
124107,6,1,1,1,1,1,3,一般用户
124125,1,1,1,4,1,1,6,新用户
124127,6,5,5,1,3,3,7,流失高价值用户
124129,1,1,1,4,1,1,6,新用户
124152,1,2,2,4,1,1,6,新用户
124170,8,1,1,1,1,1,3,一般用户
124171,2,2,2,4,1,1,6,新用户
124180,0,2,2,4,1,1,6,新用户
124194,2,3,3,4,2,2,8,潜力用户
124232,5,5,5,2,3,3,8,流失高价值用户
124236,8,2,2,1,1,1,3,一般用户
124245,7,1,1,1,1,1,3,一般用户
124252,2,1,1,4,1,1,6,新用户
124260,2,2,2,4,1,1,6,新用户
124273,4,3,3,2,2,2,6,一般用户
124274,0,4,4,4,3,3,10,高价值用户
124291,1,2,2,4,1,1,6,新用户
124295,0,1,1,4,1,1,6,新用户
124298,4,5,5,2,3,3,8,流失高价值用户
124310,7,1,1,1,1,1,3,一般用户
124361,1,1,1,4,1,1,6,新用户
124370,6,1,1,1,1,1,3,一般用户
124372,0,2,2,4,1,1,6,新用户
124387,1,5,5,4,3,3,10,高价值用户
124397,1,3,3,4,2,2,8,潜力用户
124398,3,1,1,3,1,1,5,新用户
124432,3,2,2,3,1,1,5,新用户
124440,2,1,1,4,1,1,6,新用户
124456,2,1,1,4,1,1,6,新用户
124466,0,2,2,4,1,1,6,新用户
124485,7,1,1,1,1,1,3,一般用户
124494,2,1,1,4,1,1,6,新用户
124505,3,3,3,3,2,2,7,潜力用户
124507,0,4,4,4,3,3,10,高价值用户
124509,4,1,1,2,1,1,4,一般用户
124516,6,3,3,1,2,2,5,一般用户
124533,4,1,1,2,1,1,4,一般用户
124538,1,3,3,4,2,2,8,潜力用户
124578,8,1,1,1,1,1,3,一般用户
124590,2,1,1,4,1,1,6,新用户
124610,1,1,1,4,1,1,6,新用户
124622,0,1,1,4,1,1,6,新用户
124623,4,3,3,2,2,2,6,一般用户
124625,2,1,1,4,1,1,6,新用户
124638,5,1,1,2,1,1,4,一般用户
124641,5,1,1,2,1,1,4,一般用户
124660,1,1,1,4,1,1,6,新用户
124666,7,1,1,1,1,1,3,一般用户
124672,3,2,2,3,1,1,5,新用户
124674,6,3,3,1,2,2,5,一般用户
124677,0,1,1,4,1,1,6,新用户
124678,1,1,1,4,1,1,6,新用户
124713,3,1,1,3,1,1,5,新用户
124728,2,1,1,4,1,1,6,新用户
124744,8,1,1,1,1,1,3,一般用户
124759,1,1,1,4,1,1,6,新用户
124762,2,1,1,4,1,1,6,新用户
124787,4,2,2,2,1,1,4,一般用户
124806,5,4,4,2,3,3,8,流失高价值用户
124809,1,2,2,4,1,1,6,新用户
124811,0,4,4,4,3,3,10,高价值用户
124813,0,5,5,4,3,3,10,高价值用户
124815,1,1,1,4,1,1,6,新用户
124821,1,1,1,4,1,1,6,新用户
124832,8,1,1,1,1,1,3,一般用户
124837,2,1,1,4,1,1,6,新用户
124848,7,2,2,1,1,1,3,一般用户
124862,0,1,1,4,1,1,6,新用户
124867,0,3,3,4,2,2,8,潜力用户
124871,2,1,1,4,1,1,6,新用户
124872,0,1,1,4,1,1,6,新用户
124879,7,2,2,1,1,1,3,一般用户
124892,1,2,2,4,1,1,6,新用户
124900,0,1,1,4,1,1,6,新用户
124905,2,3,3,4,2,2,8,潜力用户
124907,7,1,1,1,1,1,3,一般用户
124916,0,3,3,4,2,2,8,潜力用户
124917,0,1,1,4,1,1,6,新用户
124927,5,3,3,2,2,2,6,一般用户
124935,3,2,2,3,1,1,5,新用户
124962,6,1,1,1,1,1,3,一般用户
124988,4,1,1,2,1,1,4,一般用户
125008,1,1,1,4,1,1,6,新用户
125023,5,2,2,2,1,1,4,一般用户
125035,0,1,1,4,1,1,6,新用户
125038,2,3,3,4,2,2,8,潜力用户
125040,2,1,1,4,1,1,6,新用户
125050,3,2,2,3,1,1,5,新用户
125052,0,2,2,4,1,1,6,新用户
125061,8,5,5,1,3,3,7,流失高价值用户
125078,0,3,3,4,2,2,8,潜力用户
125090,5,4,4,2,3,3,8,流失高价值用户
125109,2,1,1,4,1,1,6,新用户
125112,2,5,5,4,3,3,10,高价值用户
125122,3,1,1,3,1,1,5,新用户
125164,1,2,2,4,1,1,6,新用户
125176,2,2,2,4,1,1,6,新用户
125187,0,9,9,4,3,3,10,高价值用户
125192,6,1,1,1,1,1,3,一般用户
125205,0,4,4,4,3,3,10,高价值用户
125210,0,2,2,4,1,1,6,新用户
125217,6,1,1,1,1,1,3,一般用户
125230,3,5,5,3,3,3,9,高价值用户
125254,1,2,2,4,1,1,6,新用户
125265,4,1,1,2,1,1,4,一般用户
125270,6,1,1,1,1,1,3,一般用户
125303,3,9,9,3,3,3,9,高价值用户
125307,0,5,5,4,3,3,10,高价值用户
125344,3,7,7,3,3,3,9,高价值用户
125348,2,3,3,4,2,2,8,潜力用户
125355,1,5,5,4,3,3,10,高价值用户
125363,4,1,1,2,1,1,4,一般用户
125364,0,3,3,4,2,2,8,潜力用户
125365,5,1,1,2,1,1,4,一般用户
125377,0,5,5,4,3,3,10,高价值用户
125401,1,5,5,4,3,3,10,高价值用户
125421,1,1,1,4,1,1,6,新用户
125422,6,9,9,1,3,3,7,流失高价值用户
125429,6,1,1,1,1,1,3,一般用户
125438,2,1,1,4,1,1,6,新用户
125447,3,3,3,3,2,2,7,潜力用户
125457,2,1,1,4,1,1,6,新用户
125461,1,2,2,4,1,1,6,新用户
125475,3,1,1,3,1,1,5,新用户
125477,4,4,4,2,3,3,8,流失高价值用户
125482,7,4,4,1,3,3,7,流失高价值用户
125503,1,5,5,4,3,3,10,高价值用户
125508,1,2,2,4,1,1,6,新用户
125518,2,5,5,4,3,3,10,高价值用户
125519,5,1,1,2,1,1,4,一般用户
125524,0,1,1,4,1,1,6,新用户
125537,0,4,4,4,3,3,10,高价值用户
125552,3,2,2,3,1,1,5,新用户
125555,7,1,1,1,1,1,3,一般用户
125557,3,5,5,3,3,3,9,高价值用户
125559,0,3,3,4,2,2,8,潜力用户
125568,0,1,1,4,1,1,6,新用户
125575,7,2,2,1,1,1,3,一般用户
125578,0,2,2,4,1,1,6,新用户
125580,0,2,2,4,1,1,6,新用户
125587,3,4,4,3,3,3,9,高价值用户
125621,0,1,1,4,1,1,6,新用户
125623,2,3,3,4,2,2,8,潜力用户
125624,5,3,3,2,2,2,6,一般用户
125653,0,1,1,4,1,1,6,新用户
125674,0,9,9,4,3,3,10,高价值用户
125693,6,2,2,1,1,1,3,一般用户
125740,7,1,1,1,1,1,3,一般用户
125746,2,3,3,4,2,2,8,潜力用户
125757,4,1,1,2,1,1,4,一般用户
125759,3,1,1,3,1,1,5,新用户
125791,5,1,1,2,1,1,4,一般用户
125795,4,1,1,2,1,1,4,一般用户
125798,3,1,1,3,1,1,5,新用户
125800,3,2,2,3,1,1,5,新用户
125802,5,3,3,2,2,2,6,一般用户
125811,0,1,1,4,1,1,6,新用户
125815,7,2,2,1,1,1,3,一般用户
125818,6,1,1,1,1,1,3,一般用户
125835,7,1,1,1,1,1,3,一般用户
125838,6,1,1,1,1,1,3,一般用户
125864,1,4,4,4,3,3,10,高价值用户
125887,5,1,1,2,1,1,4,一般用户
125903,2,1,1,4,1,1,6,新用户
125920,4,1,1,2,1,1,4,一般用户
125924,5,2,2,2,1,1,4,一般用户
125945,6,1,1,1,1,1,3,一般用户
125946,8,1,1,1,1,1,3,一般用户
125966,3,1,1,3,1,1,5,新用户
125983,4,3,3,2,2,2,6,一般用户
125987,1,1,1,4,1,1,6,新用户
125999,4,1,1,2,1,1,4,一般用户
126015,3,2,2,3,1,1,5,新用户
126016,7,3,3,1,2,2,5,一般用户
126024,5,1,1,2,1,1,4,一般用户
126031,3,1,1,3,1,1,5,新用户
126052,2,1,1,4,1,1,6,新用户
126071,0,4,4,4,3,3,10,高价值用户
126073,0,1,1,4,1,1,6,新用户
126075,3,2,2,3,1,1,5,新用户
126128,3,3,3,3,2,2,7,潜力用户
126145,1,3,3,4,2,2,8,潜力用户
126150,5,2,2,2,1,1,4,一般用户
126151,2,2,2,4,1,1,6,新用户
126174,5,1,1,2,1,1,4,一般用户
126186,0,3,3,4,2,2,8,潜力用户
126195,8,1,1,1,1,1,3,一般用户
126196,6,2,2,1,1,1,3,一般用户
126214,0,1,1,4,1,1,6,新用户
126235,0,1,1,4,1,1,6,新用户
126247,7,1,1,1,1,1,3,一般用户
126267,4,1,1,2,1,1,4,一般用户
126289,0,1,1,4,1,1,6,新用户
126314,3,3,3,3,2,2,7,潜力用户
126327,3,2,2,3,1,1,5,新用户
126332,3,3,3,3,2,2,7,潜力用户
126343,0,4,4,4,3,3,10,高价值用户
126357,7,1,1,1,1,1,3,一般用户
126365,0,3,3,4,2,2,8,潜力用户
126376,4,2,2,2,1,1,4,一般用户
126412,2,1,1,4,1,1,6,新用户
126413,7,2,2,1,1,1,3,一般用户
126428,8,1,1,1,1,1,3,一般用户
126438,7,2,2,1,1,1,3,一般用户
126448,6,1,1,1,1,1,3,一般用户
126468,1,5,5,4,3,3,10,高价值用户
126470,2,1,1,4,1,1,6,新用户
126482,0,4,4,4,3,3,10,高价值用户
126491,2,1,1,4,1,1,6,新用户
126492,6,1,1,1,1,1,3,一般用户
126500,0,1,1,4,1,1,6,新用户
126515,2,2,2,4,1,1,6,新用户
126526,1,2,2,4,1,1,6,新用户
126537,5,3,3,2,2,2,6,一般用户
126554,7,5,5,1,3,3,7,流失高价值用户
126565,5,1,1,2,1,1,4,一般用户
126569,5,2,2,2,1,1,4,一般用户
126583,3,1,1,3,1,1,5,新用户
126603,1,3,3,4,2,2,8,潜力用户
126605,2,2,2,4,1,1,6,新用户
126619,2,1,1,4,1,1,6,新用户
126631,5,1,1,2,1,1,4,一般用户
126641,1,7,7,4,3,3,10,高价值用户
126651,5,1,1,2,1,1,4,一般用户
126668,5,1,1,2,1,1,4,一般用户
126686,2,4,4,4,3,3,10,高价值用户
126695,8,1,1,1,1,1,3,一般用户
126696,7,12,12,1,3,3,7,流失高价值用户
126704,1,3,3,4,2,2,8,潜力用户
126725,3,1,1,3,1,1,5,新用户
126733,4,3,3,2,2,2,6,一般用户
126745,6,1,1,1,1,1,3,一般用户
126749,7,2,2,1,1,1,3,一般用户
126754,4,2,2,2,1,1,4,一般用户
126758,7,3,3,1,2,2,5,一般用户
126768,7,1,1,1,1,1,3,一般用户
126775,0,2,2,4,1,1,6,新用户
126787,1,1,1,4,1,1,6,新用户
126793,2,1,1,4,1,1,6,新用户
126794,5,6,6,2,3,3,8,流失高价值用户
126873,8,1,1,1,1,1,3,一般用户
126879,6,4,4,1,3,3,7,流失高价值用户
126896,4,1,1,2,1,1,4,一般用户
126898,3,1,1,3,1,1,5,新用户
126900,3,3,3,3,2,2,7,潜力用户
126903,2,1,1,4,1,1,6,新用户
126905,3,3,3,3,2,2,7,潜力用户
126906,3,6,6,3,3,3,9,高价值用户
126908,0,1,1,4,1,1,6,新用户
126923,5,1,1,2,1,1,4,一般用户
126935,1,3,3,4,2,2,8,潜力用户
126944,0,2,2,4,1,1,6,新用户
126947,3,1,1,3,1,1,5,新用户
126955,2,1,1,4,1,1,6,新用户
126965,7,1,1,1,1,1,3,一般用户
126969,8,1,1,1,1,1,3,一般用户
126971,1,1,1,4,1,1,6,新用户
126972,3,2,2,3,1,1,5,新用户
126999,1,1,1,4,1,1,6,新用户
127010,0,6,6,4,3,3,10,高价值用户
127013,4,1,1,2,1,1,4,一般用户
127015,5,1,1,2,1,1,4,一般用户
127054,4,3,3,2,2,2,6,一般用户
127055,6,2,2,1,1,1,3,一般用户
127057,0,1,1,4,1,1,6,新用户
127058,3,1,1,3,1,1,5,新用户
127069,3,1,1,3,1,1,5,新用户
127085,0,3,3,4,2,2,8,潜力用户
127113,0,3,3,4,2,2,8,潜力用户
127125,0,1,1,4,1,1,6,新用户
127135,2,3,3,4,2,2,8,潜力用户
127139,0,1,1,4,1,1,6,新用户
127141,4,2,2,2,1,1,4,一般用户
127178,1,1,1,4,1,1,6,新用户
127180,1,4,4,4,3,3,10,高价值用户
127181,5,1,1,2,1,1,4,一般用户
127182,3,1,1,3,1,1,5,新用户
127194,1,2,2,4,1,1,6,新用户
127206,7,1,1,1,1,1,3,一般用户
127208,5,3,3,2,2,2,6,一般用户
127210,5,1,1,2,1,1,4,一般用户
127224,0,2,2,4,1,1,6,新用户
127260,5,3,3,2,2,2,6,一般用户
127268,8,1,1,1,1,1,3,一般用户
127276,2,9,9,4,3,3,10,高价值用户
127282,3,1,1,3,1,1,5,新用户
127336,7,2,2,1,1,1,3,一般用户
127340,0,3,3,4,2,2,8,潜力用户
127342,4,1,1,2,1,1,4,一般用户
127345,1,4,4,4,3,3,10,高价值用户
127355,0,2,2,4,1,1,6,新用户
127367,3,1,1,3,1,1,5,新用户
127384,0,1,1,4,1,1,6,新用户
127398,3,4,4,3,3,3,9,高价值用户
127407,1,2,2,4,1,1,6,新用户
127417,0,1,1,4,1,1,6,新用户
127419,0,5,5,4,3,3,10,高价值用户
127435,0,2,2,4,1,1,6,新用户
127500,1,1,1,4,1,1,6,新用户
127501,3,2,2,3,1,1,5,新用户
127507,4,5,5,2,3,3,8,流失高价值用户
127522,5,1,1,2,1,1,4,一般用户
127529,0,1,1,4,1,1,6,新用户
127532,4,3,3,2,2,2,6,一般用户
127538,8,1,1,1,1,1,3,一般用户
127542,1,1,1,4,1,1,6,新用户
127543,2,2,2,4,1,1,6,新用户
127548,1,2,2,4,1,1,6,新用户
127550,3,4,4,3,3,3,9,高价值用户
127556,0,3,3,4,2,2,8,潜力用户
127564,1,2,2,4,1,1,6,新用户
127582,0,1,1,4,1,1,6,新用户
127607,3,1,1,3,1,1,5,新用户
127611,7,1,1,1,1,1,3,一般用户
127615,3,1,1,3,1,1,5,新用户
127621,1,5,5,4,3,3,10,高价值用户
127624,4,2,2,2,1,1,4,一般用户
127627,6,1,1,1,1,1,3,一般用户
127628,2,3,3,4,2,2,8,潜力用户
127647,3,1,1,3,1,1,5,新用户
127657,2,2,2,4,1,1,6,新用户
127674,5,2,2,2,1,1,4,一般用户
127677,0,1,1,4,1,1,6,新用户
127684,0,1,1,4,1,1,6,新用户
127687,1,1,1,4,1,1,6,新用户
127699,1,2,2,4,1,1,6,新用户
127713,0,1,1,4,1,1,6,新用户
127726,4,2,2,2,1,1,4,一般用户
127743,4,3,3,2,2,2,6,一般用户
127744,6,1,1,1,1,1,3,一般用户
127749,0,1,1,4,1,1,6,新用户
127768,0,8,8,4,3,3,10,高价值用户
127773,0,1,1,4,1,1,6,新用户
127774,3,2,2,3,1,1,5,新用户
127818,6,2,2,1,1,1,3,一般用户
127830,1,1,1,4,1,1,6,新用户
127856,0,2,2,4,1,1,6,新用户
127866,0,4,4,4,3,3,10,高价值用户
127869,0,1,1,4,1,1,6,新用户
127876,1,1,1,4,1,1,6,新用户
127883,0,9,9,4,3,3,10,高价值用户
127906,4,1,1,2,1,1,4,一般用户
127927,5,1,1,2,1,1,4,一般用户
127938,3,2,2,3,1,1,5,新用户
127942,0,4,4,4,3,3,10,高价值用户
127944,3,3,3,3,2,2,7,潜力用户
127953,7,1,1,1,1,1,3,一般用户
127965,7,1,1,1,1,1,3,一般用户
127969,4,2,2,2,1,1,4,一般用户
127972,7,1,1,1,1,1,3,一般用户
127978,0,2,2,4,1,1,6,新用户
127981,0,5,5,4,3,3,10,高价值用户
127996,4,1,1,2,1,1,4,一般用户
128000,2,14,14,4,3,3,10,高价值用户
128022,7,1,1,1,1,1,3,一般用户
128031,0,3,3,4,2,2,8,潜力用户
128035,3,2,2,3,1,1,5,新用户
128045,4,2,2,2,1,1,4,一般用户
128073,2,4,4,4,3,3,10,高价值用户
128078,4,1,1,2,1,1,4,一般用户
128092,0,1,1,4,1,1,6,新用户
128108,5,2,2,2,1,1,4,一般用户
128113,0,11,11,4,3,3,10,高价值用户
128129,7,2,2,1,1,1,3,一般用户
128131,7,1,1,1,1,1,3,一般用户
128145,6,2,2,1,1,1,3,一般用户
128162,3,2,2,3,1,1,5,新用户
128186,4,4,4,2,3,3,8,流失高价值用户
128196,2,2,2,4,1,1,6,新用户
128212,3,9,9,3,3,3,9,高价值用户
128218,5,7,7,2,3,3,8,流失高价值用户
128224,0,1,1,4,1,1,6,新用户
128229,0,6,6,4,3,3,10,高价值用户
128230,5,1,1,2,1,1,4,一般用户
128260,4,6,6,2,3,3,8,流失高价值用户
128271,1,1,1,4,1,1,6,新用户
128325,4,2,2,2,1,1,4,一般用户
128329,7,2,2,1,1,1,3,一般用户
128338,1,1,1,4,1,1,6,新用户
128351,7,4,4,1,3,3,7,流失高价值用户
128362,8,1,1,1,1,1,3,一般用户
128371,7,1,1,1,1,1,3,一般用户
128372,6,6,6,1,3,3,7,流失高价值用户
128377,0,8,8,4,3,3,10,高价值用户
128390,0,1,1,4,1,1,6,新用户
128391,7,1,1,1,1,1,3,一般用户
128392,0,2,2,4,1,1,6,新用户
128393,6,3,3,1,2,2,5,一般用户
128401,3,1,1,3,1,1,5,新用户
128406,7,1,1,1,1,1,3,一般用户
128408,2,3,3,4,2,2,8,潜力用户
128417,0,2,2,4,1,1,6,新用户
128422,4,1,1,2,1,1,4,一般用户
128434,5,1,1,2,1,1,4,一般用户
128447,2,2,2,4,1,1,6,新用户
128451,6,1,1,1,1,1,3,一般用户
128465,0,2,2,4,1,1,6,新用户
128469,2,1,1,4,1,1,6,新用户
128472,2,1,1,4,1,1,6,新用户
128480,2,3,3,4,2,2,8,潜力用户
128512,4,1,1,2,1,1,4,一般用户
128516,1,2,2,4,1,1,6,新用户
128524,2,1,1,4,1,1,6,新用户
128525,8,1,1,1,1,1,3,一般用户
128529,0,2,2,4,1,1,6,新用户
128536,3,1,1,3,1,1,5,新用户
128539,2,6,6,4,3,3,10,高价值用户
128557,8,1,1,1,1,1,3,一般用户
128572,3,2,2,3,1,1,5,新用户
128573,3,2,2,3,1,1,5,新用户
128590,5,1,1,2,1,1,4,一般用户
128591,1,1,1,4,1,1,6,新用户
1000001,0,1,1,4,1,1,6,新用户
1000011,8,1,1,1,1,1,3,一般用户
1000028,0,2,2,4,1,1,6,新用户
1000037,2,3,3,4,2,2,8,潜力用户
1000054,1,3,3,4,2,2,8,潜力用户
1000061,0,3,3,4,2,2,8,潜力用户
1000084,0,5,5,4,3,3,10,高价值用户
1000085,2,9,9,4,3,3,10,高价值用户
1000103,0,3,3,4,2,2,8,潜力用户
1000115,1,6,6,4,3,3,10,高价值用户
1000134,8,1,1,1,1,1,3,一般用户
1000135,5,1,1,2,1,1,4,一般用户
1000154,7,1,1,1,1,1,3,一般用户
1000165,2,2,2,4,1,1,6,新用户
1000169,3,1,1,3,1,1,5,新用户
1000186,3,1,1,3,1,1,5,新用户
1000191,1,2,2,4,1,1,6,新用户
1000209,5,1,1,2,1,1,4,一般用户
1000222,4,2,2,2,1,1,4,一般用户
1000228,3,5,5,3,3,3,9,高价值用户
1000236,3,1,1,3,1,1,5,新用户
1000251,5,3,3,2,2,2,6,一般用户
1000263,1,2,2,4,1,1,6,新用户
1000269,0,2,2,4,1,1,6,新用户
1000274,6,1,1,1,1,1,3,一般用户
1000313,1,5,5,4,3,3,10,高价值用户
1000319,0,1,1,4,1,1,6,新用户
1000328,0,1,1,4,1,1,6,新用户
1000332,0,1,1,4,1,1,6,新用户
1000335,0,5,5,4,3,3,10,高价值用户
1000349,1,8,8,4,3,3,10,高价值用户
1000364,5,1,1,2,1,1,4,一般用户
1000398,0,4,4,4,3,3,10,高价值用户
1000408,6,2,2,1,1,1,3,一般用户
1000417,4,2,2,2,1,1,4,一般用户
1000420,5,1,1,2,1,1,4,一般用户
1000429,0,3,3,4,2,2,8,潜力用户
1000436,0,2,2,4,1,1,6,新用户
1000438,0,2,2,4,1,1,6,新用户
1000488,0,9,9,4,3,3,10,高价值用户
1000490,3,2,2,3,1,1,5,新用户
1000497,4,1,1,2,1,1,4,一般用户
1000505,6,3,3,1,2,2,5,一般用户
1000520,1,2,2,4,1,1,6,新用户
1000538,0,1,1,4,1,1,6,新用户
1000539,2,1,1,4,1,1,6,新用户
1000541,1,1,1,4,1,1,6,新用户
1000573,4,2,2,2,1,1,4,一般用户
1000581,6,1,1,1,1,1,3,一般用户
1000588,2,1,1,4,1,1,6,新用户
1000596,4,1,1,2,1,1,4,一般用户
1000610,0,3,3,4,2,2,8,潜力用户
1000630,6,1,1,1,1,1,3,一般用户
1000641,3,4,4,3,3,3,9,高价值用户
1000664,3,3,3,3,2,2,7,潜力用户
1000676,1,2,2,4,1,1,6,新用户
1000684,0,7,7,4,3,3,10,高价值用户
1000686,2,1,1,4,1,1,6,新用户
1000703,4,2,2,2,1,1,4,一般用户
1000712,5,2,2,2,1,1,4,一般用户
1000715,2,1,1,4,1,1,6,新用户
1000718,3,3,3,3,2,2,7,潜力用户
1000722,4,1,1,2,1,1,4,一般用户
1000723,1,11,11,4,3,3,10,高价值用户
1000727,0,1,1,4,1,1,6,新用户
1000735,2,1,1,4,1,1,6,新用户
1000749,7,1,1,1,1,1,3,一般用户
1000751,6,1,1,1,1,1,3,一般用户
1000792,6,3,3,1,2,2,5,一般用户
1000803,7,1,1,1,1,1,3,一般用户
1000807,3,2,2,3,1,1,5,新用户
1000811,3,1,1,3,1,1,5,新用户
1000836,4,1,1,2,1,1,4,一般用户
1000856,3,3,3,3,2,2,7,潜力用户
1000865,2,1,1,4,1,1,6,新用户
1000872,2,2,2,4,1,1,6,新用户
1000877,3,7,7,3,3,3,9,高价值用户
1000878,2,4,4,4,3,3,10,高价值用户
1000896,7,1,1,1,1,1,3,一般用户
1000911,0,3,3,4,2,2,8,潜力用户
1000916,2,1,1,4,1,1,6,新用户
1000919,5,1,1,2,1,1,4,一般用户
1000922,4,1,1,2,1,1,4,一般用户
1000923,1,1,1,4,1,1,6,新用户
1000936,6,1,1,1,1,1,3,一般用户
1000937,2,4,4,4,3,3,10,高价值用户
1000984,3,1,1,3,1,1,5,新用户
1001009,3,2,2,3,1,1,5,新用户
1001017,5,2,2,2,1,1,4,一般用户
1001024,4,1,1,2,1,1,4,一般用户
1001054,0,4,4,4,3,3,10,高价值用户
1001081,1,4,4,4,3,3,10,高价值用户
1001088,8,1,1,1,1,1,3,一般用户
1001099,2,4,4,4,3,3,10,高价值用户
1001102,1,2,2,4,1,1,6,新用户
1001104,5,1,1,2,1,1,4,一般用户
1001108,7,1,1,1,1,1,3,一般用户
1001120,8,3,3,1,2,2,5,一般用户
1001121,3,1,1,3,1,1,5,新用户
1001138,0,1,1,4,1,1,6,新用户
1001145,2,1,1,4,1,1,6,新用户
1001151,2,2,2,4,1,1,6,新用户
1001154,4,1,1,2,1,1,4,一般用户
1001185,4,1,1,2,1,1,4,一般用户
1001186,7,2,2,1,1,1,3,一般用户
1001199,7,4,4,1,3,3,7,流失高价值用户
1001232,3,3,3,3,2,2,7,潜力用户
1001235,0,3,3,4,2,2,8,潜力用户
1001241,6,1,1,1,1,1,3,一般用户
1001248,7,1,1,1,1,1,3,一般用户
1001270,1,2,2,4,1,1,6,新用户
1001301,6,1,1,1,1,1,3,一般用户
1001305,3,14,14,3,3,3,9,高价值用户
1001313,1,1,1,4,1,1,6,新用户
1001346,6,1,1,1,1,1,3,一般用户
1001352,1,1,1,4,1,1,6,新用户
1001373,6,2,2,1,1,1,3,一般用户
1001375,0,6,6,4,3,3,10,高价值用户
1001378,7,1,1,1,1,1,3,一般用户
1001404,2,2,2,4,1,1,6,新用户
1001419,2,4,4,4,3,3,10,高价值用户
1001421,7,1,1,1,1,1,3,一般用户
1001460,4,1,1,2,1,1,4,一般用户
1001461,3,5,5,3,3,3,9,高价值用户
1001466,0,2,2,4,1,1,6,新用户
1001472,8,4,4,1,3,3,7,流失高价值用户
1001492,5,1,1,2,1,1,4,一般用户
1001512,2,1,1,4,1,1,6,新用户
1001531,0,1,1,4,1,1,6,新用户
1001532,1,1,1,4,1,1,6,新用户
1001537,0,6,6,4,3,3,10,高价值用户
1001562,3,1,1,3,1,1,5,新用户
1001566,2,5,5,4,3,3,10,高价值用户
1001569,5,2,2,2,1,1,4,一般用户
1001578,7,1,1,1,1,1,3,一般用户
1001596,1,1,1,4,1,1,6,新用户
1001601,3,1,1,3,1,1,5,新用户
1001606,2,1,1,4,1,1,6,新用户
1001608,6,1,1,1,1,1,3,一般用户
1001618,7,1,1,1,1,1,3,一般用户
1001625,7,2,2,1,1,1,3,一般用户
1001626,3,1,1,3,1,1,5,新用户
1001629,1,3,3,4,2,2,8,潜力用户
1001652,0,1,1,4,1,1,6,新用户
1001654,2,1,1,4,1,1,6,新用户
1001662,3,7,7,3,3,3,9,高价值用户
1001673,4,2,2,2,1,1,4,一般用户
1001676,0,2,2,4,1,1,6,新用户
1001686,2,1,1,4,1,1,6,新用户
1001689,2,1,1,4,1,1,6,新用户
1001700,5,1,1,2,1,1,4,一般用户
1001711,0,3,3,4,2,2,8,潜力用户
1001737,3,2,2,3,1,1,5,新用户
1001757,0,1,1,4,1,1,6,新用户
1001769,8,1,1,1,1,1,3,一般用户
1001783,1,4,4,4,3,3,10,高价值用户
1001784,5,2,2,2,1,1,4,一般用户
1001788,5,2,2,2,1,1,4,一般用户
1001803,4,2,2,2,1,1,4,一般用户
1001809,4,1,1,2,1,1,4,一般用户
1001829,1,3,3,4,2,2,8,潜力用户
1001841,1,6,6,4,3,3,10,高价值用户
1001844,2,1,1,4,1,1,6,新用户
1001847,8,1,1,1,1,1,3,一般用户
1001855,4,2,2,2,1,1,4,一般用户
1001856,2,4,4,4,3,3,10,高价值用户
1001860,2,3,3,4,2,2,8,潜力用户
1001866,3,13,13,3,3,3,9,高价值用户
1001872,6,2,2,1,1,1,3,一般用户
1001875,2,3,3,4,2,2,8,潜力用户
1001876,0,2,2,4,1,1,6,新用户
1001877,1,3,3,4,2,2,8,潜力用户
1001879,0,2,2,4,1,1,6,新用户
1001882,0,1,1,4,1,1,6,新用户
1001902,0,1,1,4,1,1,6,新用户
1001921,1,4,4,4,3,3,10,高价值用户
1001944,6,2,2,1,1,1,3,一般用户
1001947,1,1,1,4,1,1,6,新用户
1001967,0,2,2,4,1,1,6,新用户
1001982,2,1,1,4,1,1,6,新用户
1001988,0,3,3,4,2,2,8,潜力用户
1002005,3,1,1,3,1,1,5,新用户
1002020,0,3,3,4,2,2,8,潜力用户
1002031,0,13,13,4,3,3,10,高价值用户
1002032,3,4,4,3,3,3,9,高价值用户
1002034,8,2,2,1,1,1,3,一般用户
1002042,0,2,2,4,1,1,6,新用户
1002046,5,6,6,2,3,3,8,流失高价值用户
1002058,5,1,1,2,1,1,4,一般用户
1002066,2,5,5,4,3,3,10,高价值用户
1002093,0,2,2,4,1,1,6,新用户
1002095,3,3,3,3,2,2,7,潜力用户
1002118,6,1,1,1,1,1,3,一般用户
1002127,0,2,2,4,1,1,6,新用户
1002128,3,2,2,3,1,1,5,新用户
1002132,5,4,4,2,3,3,8,流失高价值用户
1002142,5,1,1,2,1,1,4,一般用户
1002166,0,5,5,4,3,3,10,高价值用户
1002172,7,2,2,1,1,1,3,一般用户
1002180,0,2,2,4,1,1,6,新用户
1002185,1,3,3,4,2,2,8,潜力用户
1002188,5,1,1,2,1,1,4,一般用户
1002191,3,1,1,3,1,1,5,新用户
1002200,7,1,1,1,1,1,3,一般用户
1002201,5,2,2,2,1,1,4,一般用户
1002202,5,2,2,2,1,1,4,一般用户
1002208,0,3,3,4,2,2,8,潜力用户
1002213,7,1,1,1,1,1,3,一般用户
1002222,1,7,7,4,3,3,10,高价值用户
1002226,2,4,4,4,3,3,10,高价值用户
1002228,2,4,4,4,3,3,10,高价值用户
1002237,1,6,6,4,3,3,10,高价值用户
1002246,0,7,7,4,3,3,10,高价值用户
1002251,2,5,5,4,3,3,10,高价值用户
1002257,0,2,2,4,1,1,6,新用户
1002260,2,1,1,4,1,1,6,新用户
1002271,3,1,1,3,1,1,5,新用户
1002291,8,1,1,1,1,1,3,一般用户
1002306,4,1,1,2,1,1,4,一般用户
1002307,0,7,7,4,3,3,10,高价值用户
1002311,0,1,1,4,1,1,6,新用户
1002316,4,2,2,2,1,1,4,一般用户
1002317,0,3,3,4,2,2,8,潜力用户
1002328,5,1,1,2,1,1,4,一般用户
1002330,4,2,2,2,1,1,4,一般用户
1002331,5,3,3,2,2,2,6,一般用户
1002339,5,1,1,2,1,1,4,一般用户
1002349,5,3,3,2,2,2,6,一般用户
1002358,0,8,8,4,3,3,10,高价值用户
1002387,4,2,2,2,1,1,4,一般用户
1002388,2,4,4,4,3,3,10,高价值用户
1002413,7,3,3,1,2,2,5,一般用户
1002421,2,1,1,4,1,1,6,新用户
1002426,2,1,1,4,1,1,6,新用户
1002428,4,1,1,2,1,1,4,一般用户
1002435,7,3,3,1,2,2,5,一般用户
1002449,1,2,2,4,1,1,6,新用户
1002460,8,2,2,1,1,1,3,一般用户
1002478,6,1,1,1,1,1,3,一般用户
1002512,0,1,1,4,1,1,6,新用户
1002526,4,4,4,2,3,3,8,流失高价值用户
1002534,8,2,2,1,1,1,3,一般用户
1002542,1,1,1,4,1,1,6,新用户
1002547,1,1,1,4,1,1,6,新用户
1002564,2,1,1,4,1,1,6,新用户
1002566,3,2,2,3,1,1,5,新用户
1002578,0,3,3,4,2,2,8,潜力用户
1002587,2,3,3,4,2,2,8,潜力用户
1002589,1,5,5,4,3,3,10,高价值用户
1002618,0,3,3,4,2,2,8,潜力用户
1002637,1,6,6,4,3,3,10,高价值用户
1002642,0,1,1,4,1,1,6,新用户
1002661,1,1,1,4,1,1,6,新用户
1002672,8,1,1,1,1,1,3,一般用户
1002684,1,1,1,4,1,1,6,新用户
1002685,2,1,1,4,1,1,6,新用户
1002696,1,2,2,4,1,1,6,新用户
1002705,7,6,6,1,3,3,7,流失高价值用户
1002714,5,1,1,2,1,1,4,一般用户
1002725,5,1,1,2,1,1,4,一般用户
1002763,2,7,7,4,3,3,10,高价值用户
1002771,0,1,1,4,1,1,6,新用户
1002831,0,1,1,4,1,1,6,新用户
1002846,3,1,1,3,1,1,5,新用户
1002847,1,2,2,4,1,1,6,新用户
1002862,0,2,2,4,1,1,6,新用户
1002878,0,1,1,4,1,1,6,新用户
1002886,4,5,5,2,3,3,8,流失高价值用户
1002890,0,1,1,4,1,1,6,新用户
1002909,0,5,5,4,3,3,10,高价值用户
1002927,2,5,5,4,3,3,10,高价值用户
1002928,2,3,3,4,2,2,8,潜力用户
1002934,0,3,3,4,2,2,8,潜力用户
1002940,3,4,4,3,3,3,9,高价值用户
1002943,3,1,1,3,1,1,5,新用户
1002970,2,2,2,4,1,1,6,新用户
1002992,1,1,1,4,1,1,6,新用户
1003022,1,3,3,4,2,2,8,潜力用户
1003027,2,2,2,4,1,1,6,新用户
1003041,0,3,3,4,2,2,8,潜力用户
1003052,1,1,1,4,1,1,6,新用户
1003063,1,1,1,4,1,1,6,新用户
1003065,2,2,2,4,1,1,6,新用户
1003073,0,1,1,4,1,1,6,新用户
1003076,2,2,2,4,1,1,6,新用户
1003110,7,1,1,1,1,1,3,一般用户
1003122,6,1,1,1,1,1,3,一般用户
1003131,1,4,4,4,3,3,10,高价值用户
1003152,5,1,1,2,1,1,4,一般用户
1003157,3,2,2,3,1,1,5,新用户
1003163,7,3,3,1,2,2,5,一般用户
1003171,1,2,2,4,1,1,6,新用户
1003176,1,1,1,4,1,1,6,新用户
1003177,3,4,4,3,3,3,9,高价值用户
1003183,0,2,2,4,1,1,6,新用户
1003184,4,2,2,2,1,1,4,一般用户
1003191,2,3,3,4,2,2,8,潜力用户
1003200,0,1,1,4,1,1,6,新用户
1003221,8,1,1,1,1,1,3,一般用户
1003227,3,1,1,3,1,1,5,新用户
1003239,0,1,1,4,1,1,6,新用户
1003249,0,6,6,4,3,3,10,高价值用户
1003264,0,2,2,4,1,1,6,新用户
1003281,5,1,1,2,1,1,4,一般用户
1003292,1,1,1,4,1,1,6,新用户
1003296,1,2,2,4,1,1,6,新用户
1003298,8,1,1,1,1,1,3,一般用户
1003319,2,1,1,4,1,1,6,新用户
1003321,4,2,2,2,1,1,4,一般用户
1003326,2,1,1,4,1,1,6,新用户
1003329,6,1,1,1,1,1,3,一般用户
1003332,1,2,2,4,1,1,6,新用户
1003343,6,2,2,1,1,1,3,一般用户
1003348,0,1,1,4,1,1,6,新用户
1003351,0,3,3,4,2,2,8,潜力用户
1003390,1,4,4,4,3,3,10,高价值用户
1003397,3,2,2,3,1,1,5,新用户
1003422,0,2,2,4,1,1,6,新用户
1003428,1,5,5,4,3,3,10,高价值用户
1003432,5,1,1,2,1,1,4,一般用户
1003440,2,2,2,4,1,1,6,新用户
1003467,6,1,1,1,1,1,3,一般用户
1003475,8,1,1,1,1,1,3,一般用户
1003492,8,1,1,1,1,1,3,一般用户
1003499,8,1,1,1,1,1,3,一般用户
1003509,0,4,4,4,3,3,10,高价值用户
1003510,1,1,1,4,1,1,6,新用户
1003512,7,1,1,1,1,1,3,一般用户
1003550,4,2,2,2,1,1,4,一般用户
1003553,7,1,1,1,1,1,3,一般用户
1003559,0,1,1,4,1,1,6,新用户
1003561,0,2,2,4,1,1,6,新用户
1003571,7,1,1,1,1,1,3,一般用户
1003586,1,1,1,4,1,1,6,新用户
1003610,2,2,2,4,1,1,6,新用户
1003611,4,3,3,2,2,2,6,一般用户
1003612,3,1,1,3,1,1,5,新用户
1003627,0,2,2,4,1,1,6,新用户
1003628,0,2,2,4,1,1,6,新用户
1003643,5,2,2,2,1,1,4,一般用户
1003656,1,3,3,4,2,2,8,潜力用户
1003703,4,1,1,2,1,1,4,一般用户
1003707,4,1,1,2,1,1,4,一般用户
1003716,0,5,5,4,3,3,10,高价值用户
1003724,8,1,1,1,1,1,3,一般用户
1003743,4,1,1,2,1,1,4,一般用户
1003756,4,1,1,2,1,1,4,一般用户
1003761,1,1,1,4,1,1,6,新用户
1003766,2,1,1,4,1,1,6,新用户
1003781,3,1,1,3,1,1,5,新用户
1003821,0,1,1,4,1,1,6,新用户
1003826,0,5,5,4,3,3,10,高价值用户
1003837,3,2,2,3,1,1,5,新用户
1003838,1,3,3,4,2,2,8,潜力用户
1003855,8,1,1,1,1,1,3,一般用户
1003867,6,1,1,1,1,1,3,一般用户
1003871,8,1,1,1,1,1,3,一般用户
1003885,1,2,2,4,1,1,6,新用户
1003893,1,1,1,4,1,1,6,新用户
1003894,6,1,1,1,1,1,3,一般用户
1003901,1,31,31,4,3,3,10,高价值用户
1003906,0,7,7,4,3,3,10,高价值用户
1003914,5,1,1,2,1,1,4,一般用户
1003941,8,2,2,1,1,1,3,一般用户
1003947,6,1,1,1,1,1,3,一般用户
1003961,0,1,1,4,1,1,6,新用户
1003975,6,4,4,1,3,3,7,流失高价值用户
1003983,0,19,19,4,3,3,10,高价值用户
1003988,0,2,2,4,1,1,6,新用户
1003998,1,2,2,4,1,1,6,新用户
1004001,0,1,1,4,1,1,6,新用户
1004019,1,1,1,4,1,1,6,新用户
1004020,4,1,1,2,1,1,4,一般用户
1004021,1,2,2,4,1,1,6,新用户
1004068,1,1,1,4,1,1,6,新用户
1004075,8,1,1,1,1,1,3,一般用户
1004082,0,2,2,4,1,1,6,新用户
1004087,8,1,1,1,1,1,3,一般用户
1004096,3,4,4,3,3,3,9,高价值用户
1004106,3,3,3,3,2,2,7,潜力用户
1004118,2,1,1,4,1,1,6,新用户
1004122,6,3,3,1,2,2,5,一般用户
1004140,3,1,1,3,1,1,5,新用户
1004146,0,1,1,4,1,1,6,新用户
1004161,0,2,2,4,1,1,6,新用户
1004165,3,1,1,3,1,1,5,新用户
1004172,6,1,1,1,1,1,3,一般用户
1004183,0,2,2,4,1,1,6,新用户
1004196,5,2,2,2,1,1,4,一般用户
1004201,7,1,1,1,1,1,3,一般用户
1004207,1,1,1,4,1,1,6,新用户
1004212,4,1,1,2,1,1,4,一般用户
1004228,5,1,1,2,1,1,4,一般用户
1004232,4,3,3,2,2,2,6,一般用户
1004238,3,3,3,3,2,2,7,潜力用户
1004246,3,1,1,3,1,1,5,新用户
1004259,2,3,3,4,2,2,8,潜力用户
1004269,0,2,2,4,1,1,6,新用户
1004274,3,1,1,3,1,1,5,新用户
1004282,0,1,1,4,1,1,6,新用户
1004289,6,1,1,1,1,1,3,一般用户
1004296,5,1,1,2,1,1,4,一般用户
1004298,6,2,2,1,1,1,3,一般用户
1004302,1,1,1,4,1,1,6,新用户
1004303,8,1,1,1,1,1,3,一般用户
1004327,5,2,2,2,1,1,4,一般用户
1004337,0,4,4,4,3,3,10,高价值用户
1004339,4,2,2,2,1,1,4,一般用户
1004350,7,1,1,1,1,1,3,一般用户
1004354,0,1,1,4,1,1,6,新用户
1004357,4,1,1,2,1,1,4,一般用户
1004362,3,1,1,3,1,1,5,新用户
1004366,1,2,2,4,1,1,6,新用户
1004368,4,2,2,2,1,1,4,一般用户
1004378,2,2,2,4,1,1,6,新用户
1004381,1,4,4,4,3,3,10,高价值用户
1004396,1,2,2,4,1,1,6,新用户
1004403,5,2,2,2,1,1,4,一般用户
1004406,5,2,2,2,1,1,4,一般用户
1004410,4,2,2,2,1,1,4,一般用户
1004413,2,2,2,4,1,1,6,新用户
1004420,4,1,1,2,1,1,4,一般用户
1004441,0,1,1,4,1,1,6,新用户
1004442,6,2,2,1,1,1,3,一般用户
1004444,1,2,2,4,1,1,6,新用户
1004446,2,1,1,4,1,1,6,新用户
1004448,0,5,5,4,3,3,10,高价值用户
1004454,7,1,1,1,1,1,3,一般用户
1004463,5,9,9,2,3,3,8,流失高价值用户
1004466,5,2,2,2,1,1,4,一般用户
1004477,7,2,2,1,1,1,3,一般用户
1004497,1,1,1,4,1,1,6,新用户
1004504,4,1,1,2,1,1,4,一般用户
1004523,3,6,6,3,3,3,9,高价值用户
1004533,0,1,1,4,1,1,6,新用户
1004538,1,1,1,4,1,1,6,新用户
1004555,0,1,1,4,1,1,6,新用户
1004560,2,3,3,4,2,2,8,潜力用户
1004562,0,1,1,4,1,1,6,新用户
1004565,1,1,1,4,1,1,6,新用户
1004572,2,5,5,4,3,3,10,高价值用户
1004577,1,2,2,4,1,1,6,新用户
1004580,4,1,1,2,1,1,4,一般用户
1004584,2,6,6,4,3,3,10,高价值用户
1004603,2,6,6,4,3,3,10,高价值用户
1004651,2,2,2,4,1,1,6,新用户
1004659,1,2,2,4,1,1,6,新用户
1004663,0,3,3,4,2,2,8,潜力用户
1004681,1,1,1,4,1,1,6,新用户
1004684,3,1,1,3,1,1,5,新用户
1004701,4,1,1,2,1,1,4,一般用户
1004726,0,9,9,4,3,3,10,高价值用户
1004730,1,2,2,4,1,1,6,新用户
1004737,2,2,2,4,1,1,6,新用户
1004745,7,1,1,1,1,1,3,一般用户
1004775,7,1,1,1,1,1,3,一般用户
1004778,5,1,1,2,1,1,4,一般用户
1004785,1,2,2,4,1,1,6,新用户
1004792,1,5,5,4,3,3,10,高价值用户
1004807,0,3,3,4,2,2,8,潜力用户
1004810,0,1,1,4,1,1,6,新用户
1004834,0,2,2,4,1,1,6,新用户
1004839,6,1,1,1,1,1,3,一般用户
1004842,3,1,1,3,1,1,5,新用户
1004862,1,1,1,4,1,1,6,新用户
1004879,7,5,5,1,3,3,7,流失高价值用户
1004881,3,18,18,3,3,3,9,高价值用户
1004886,2,1,1,4,1,1,6,新用户
1004895,6,1,1,1,1,1,3,一般用户
1004936,1,1,1,4,1,1,6,新用户
1004945,5,1,1,2,1,1,4,一般用户
1004973,1,2,2,4,1,1,6,新用户
1004974,6,1,1,1,1,1,3,一般用户
1004993,1,1,1,4,1,1,6,新用户
1005022,7,1,1,1,1,1,3,一般用户
1005055,2,1,1,4,1,1,6,新用户
1005070,1,1,1,4,1,1,6,新用户
1005074,0,5,5,4,3,3,10,高价值用户
1005077,2,1,1,4,1,1,6,新用户
1005082,1,2,2,4,1,1,6,新用户
1005085,4,1,1,2,1,1,4,一般用户
1005124,5,7,7,2,3,3,8,流失高价值用户
1005134,3,2,2,3,1,1,5,新用户
1005166,0,3,3,4,2,2,8,潜力用户
1005179,5,1,1,2,1,1,4,一般用户
1005186,5,1,1,2,1,1,4,一般用户
1005233,6,1,1,1,1,1,3,一般用户
1005256,2,1,1,4,1,1,6,新用户
1005257,0,1,1,4,1,1,6,新用户
1005259,1,13,13,4,3,3,10,高价值用户
1005269,5,3,3,2,2,2,6,一般用户
1005281,7,1,1,1,1,1,3,一般用户
1005283,2,1,1,4,1,1,6,新用户
1005284,0,7,7,4,3,3,10,高价值用户
1005292,0,1,1,4,1,1,6,新用户
1005293,3,4,4,3,3,3,9,高价值用户
1005294,2,2,2,4,1,1,6,新用户
1005304,0,1,1,4,1,1,6,新用户
1005314,4,1,1,2,1,1,4,一般用户
1005320,1,2,2,4,1,1,6,新用户
1005324,8,1,1,1,1,1,3,一般用户
1005329,1,1,1,4,1,1,6,新用户
1005337,1,4,4,4,3,3,10,高价值用户
1005338,3,2,2,3,1,1,5,新用户
1005345,8,1,1,1,1,1,3,一般用户
1005383,5,1,1,2,1,1,4,一般用户
1005407,0,3,3,4,2,2,8,潜力用户
1005417,6,2,2,1,1,1,3,一般用户
1005419,0,7,7,4,3,3,10,高价值用户
1005422,7,1,1,1,1,1,3,一般用户
1005430,6,1,1,1,1,1,3,一般用户
1005455,6,2,2,1,1,1,3,一般用户
1005474,0,1,1,4,1,1,6,新用户
1005498,2,5,5,4,3,3,10,高价值用户
1005501,0,2,2,4,1,1,6,新用户
1005521,7,1,1,1,1,1,3,一般用户
1005522,6,1,1,1,1,1,3,一般用户
1005524,6,1,1,1,1,1,3,一般用户
1005541,8,1,1,1,1,1,3,一般用户
1005545,0,2,2,4,1,1,6,新用户
1005548,2,1,1,4,1,1,6,新用户
1005551,2,3,3,4,2,2,8,潜力用户
1005559,0,2,2,4,1,1,6,新用户
1005564,2,4,4,4,3,3,10,高价值用户
1005571,4,1,1,2,1,1,4,一般用户
1005572,3,2,2,3,1,1,5,新用户
1005585,1,2,2,4,1,1,6,新用户
1005616,7,7,7,1,3,3,7,流失高价值用户
1005626,3,2,2,3,1,1,5,新用户
1005627,7,1,1,1,1,1,3,一般用户
1005649,5,6,6,2,3,3,8,流失高价值用户
1005661,3,3,3,3,2,2,7,潜力用户
1005694,3,1,1,3,1,1,5,新用户
1005701,6,1,1,1,1,1,3,一般用户
1005703,5,2,2,2,1,1,4,一般用户
1005704,0,3,3,4,2,2,8,潜力用户
1005705,1,2,2,4,1,1,6,新用户
1005706,4,1,1,2,1,1,4,一般用户
1005707,3,1,1,3,1,1,5,新用户
1005712,0,2,2,4,1,1,6,新用户
1005713,7,3,3,1,2,2,5,一般用户
1005738,0,2,2,4,1,1,6,新用户
1005742,1,4,4,4,3,3,10,高价值用户
1005746,0,6,6,4,3,3,10,高价值用户
1005752,1,3,3,4,2,2,8,潜力用户
1005758,1,3,3,4,2,2,8,潜力用户
1005760,2,1,1,4,1,1,6,新用户
1005766,1,1,1,4,1,1,6,新用户
1005767,0,1,1,4,1,1,6,新用户
1005771,0,1,1,4,1,1,6,新用户
1005787,4,2,2,2,1,1,4,一般用户
1005788,5,1,1,2,1,1,4,一般用户
1005807,0,2,2,4,1,1,6,新用户
1005822,1,1,1,4,1,1,6,新用户
1005834,7,2,2,1,1,1,3,一般用户
1005837,7,1,1,1,1,1,3,一般用户
1005845,1,2,2,4,1,1,6,新用户
1005860,5,2,2,2,1,1,4,一般用户
1005866,6,2,2,1,1,1,3,一般用户
1005874,2,3,3,4,2,2,8,潜力用户
1005877,5,2,2,2,1,1,4,一般用户
1005906,5,3,3,2,2,2,6,一般用户
1005909,1,2,2,4,1,1,6,新用户
1005916,0,5,5,4,3,3,10,高价值用户
1005924,3,5,5,3,3,3,9,高价值用户
1005939,3,1,1,3,1,1,5,新用户
1005952,4,2,2,2,1,1,4,一般用户
1005953,3,2,2,3,1,1,5,新用户
1005961,0,1,1,4,1,1,6,新用户
1005981,2,1,1,4,1,1,6,新用户
1005985,6,2,2,1,1,1,3,一般用户
1005995,0,2,2,4,1,1,6,新用户
1005996,4,1,1,2,1,1,4,一般用户
1006002,0,1,1,4,1,1,6,新用户
1006003,3,5,5,3,3,3,9,高价值用户
1006015,5,1,1,2,1,1,4,一般用户
1006021,4,1,1,2,1,1,4,一般用户
1006040,0,1,1,4,1,1,6,新用户
1006079,0,1,1,4,1,1,6,新用户
1006097,2,2,2,4,1,1,6,新用户
1006110,1,4,4,4,3,3,10,高价值用户
1006121,5,1,1,2,1,1,4,一般用户
1006126,8,3,3,1,2,2,5,一般用户
1006141,1,7,7,4,3,3,10,高价值用户
1006159,8,1,1,1,1,1,3,一般用户
1006173,6,1,1,1,1,1,3,一般用户
1006178,6,1,1,1,1,1,3,一般用户
1006181,4,1,1,2,1,1,4,一般用户
1006204,3,2,2,3,1,1,5,新用户
1006207,5,1,1,2,1,1,4,一般用户
1006224,2,1,1,4,1,1,6,新用户
1006252,2,3,3,4,2,2,8,潜力用户
1006255,6,2,2,1,1,1,3,一般用户
1006261,1,1,1,4,1,1,6,新用户
1006262,4,4,4,2,3,3,8,流失高价值用户
1006267,1,2,2,4,1,1,6,新用户
1006274,1,2,2,4,1,1,6,新用户
1006306,8,1,1,1,1,1,3,一般用户
1006307,1,11,11,4,3,3,10,高价值用户
1006309,3,1,1,3,1,1,5,新用户
1006312,5,3,3,2,2,2,6,一般用户
1006317,3,1,1,3,1,1,5,新用户
1006322,2,3,3,4,2,2,8,潜力用户
1006389,5,2,2,2,1,1,4,一般用户
1006392,4,2,2,2,1,1,4,一般用户
1006398,1,1,1,4,1,1,6,新用户
1006402,5,4,4,2,3,3,8,流失高价值用户
1006405,1,1,1,4,1,1,6,新用户
1006411,1,2,2,4,1,1,6,新用户
1006422,0,1,1,4,1,1,6,新用户
1006432,3,3,3,3,2,2,7,潜力用户
1006439,6,1,1,1,1,1,3,一般用户
1006446,0,1,1,4,1,1,6,新用户
1006448,6,3,3,1,2,2,5,一般用户
1006451,5,1,1,2,1,1,4,一般用户
1006453,2,1,1,4,1,1,6,新用户
1006469,1,2,2,4,1,1,6,新用户
1006471,2,2,2,4,1,1,6,新用户
1006480,0,1,1,4,1,1,6,新用户
1006481,2,1,1,4,1,1,6,新用户
1006482,1,6,6,4,3,3,10,高价值用户
1006495,7,1,1,1,1,1,3,一般用户
1006510,4,3,3,2,2,2,6,一般用户
1006525,1,3,3,4,2,2,8,潜力用户
1006538,1,2,2,4,1,1,6,新用户
1006553,1,2,2,4,1,1,6,新用户
1006582,0,5,5,4,3,3,10,高价值用户
1006585,1,1,1,4,1,1,6,新用户
1006586,6,1,1,1,1,1,3,一般用户
1006593,2,1,1,4,1,1,6,新用户
1006597,3,4,4,3,3,3,9,高价值用户
1006616,3,11,11,3,3,3,9,高价值用户
1006618,6,1,1,1,1,1,3,一般用户
1006634,7,1,1,1,1,1,3,一般用户
1006647,6,1,1,1,1,1,3,一般用户
1006651,3,4,4,3,3,3,9,高价值用户
1006653,6,3,3,1,2,2,5,一般用户
1006660,1,1,1,4,1,1,6,新用户
1006666,1,3,3,4,2,2,8,潜力用户
1006678,4,1,1,2,1,1,4,一般用户
1006698,0,1,1,4,1,1,6,新用户
1006704,6,1,1,1,1,1,3,一般用户
1006707,0,2,2,4,1,1,6,新用户
1006740,6,3,3,1,2,2,5,一般用户
1006745,5,7,7,2,3,3,8,流失高价值用户
1006754,3,2,2,3,1,1,5,新用户
1006765,0,4,4,4,3,3,10,高价值用户
1006767,4,1,1,2,1,1,4,一般用户
1006768,2,1,1,4,1,1,6,新用户
1006784,6,1,1,1,1,1,3,一般用户
1006803,4,3,3,2,2,2,6,一般用户
1006817,1,1,1,4,1,1,6,新用户
1006823,6,1,1,1,1,1,3,一般用户
1006851,2,2,2,4,1,1,6,新用户
1006864,3,4,4,3,3,3,9,高价值用户
1006872,1,12,12,4,3,3,10,高价值用户
1006889,4,1,1,2,1,1,4,一般用户
1006894,5,1,1,2,1,1,4,一般用户
1006897,0,11,11,4,3,3,10,高价值用户
1006919,3,2,2,3,1,1,5,新用户
1006920,0,3,3,4,2,2,8,潜力用户
1006925,8,1,1,1,1,1,3,一般用户
1006935,3,2,2,3,1,1,5,新用户
1006938,0,2,2,4,1,1,6,新用户
1006939,4,1,1,2,1,1,4,一般用户
1006940,5,2,2,2,1,1,4,一般用户
1006943,5,1,1,2,1,1,4,一般用户
1006954,3,2,2,3,1,1,5,新用户
1006964,0,3,3,4,2,2,8,潜力用户
1006977,3,1,1,3,1,1,5,新用户
1006984,0,1,1,4,1,1,6,新用户
1006992,2,2,2,4,1,1,6,新用户
1007004,0,2,2,4,1,1,6,新用户
1007020,2,2,2,4,1,1,6,新用户
1007027,1,2,2,4,1,1,6,新用户
1007028,5,1,1,2,1,1,4,一般用户
1007031,4,1,1,2,1,1,4,一般用户
1007035,0,7,7,4,3,3,10,高价值用户
1007037,1,2,2,4,1,1,6,新用户
1007046,5,2,2,2,1,1,4,一般用户
1007057,6,1,1,1,1,1,3,一般用户
1007071,0,19,19,4,3,3,10,高价值用户
1007078,0,12,12,4,3,3,10,高价值用户
1007082,4,1,1,2,1,1,4,一般用户
1007088,1,1,1,4,1,1,6,新用户
1007112,0,5,5,4,3,3,10,高价值用户
1007148,2,3,3,4,2,2,8,潜力用户
1007163,1,2,2,4,1,1,6,新用户
1007171,0,4,4,4,3,3,10,高价值用户
1007181,2,7,7,4,3,3,10,高价值用户
1007190,0,3,3,4,2,2,8,潜力用户
1007192,0,1,1,4,1,1,6,新用户
1007200,7,1,1,1,1,1,3,一般用户
1007201,1,1,1,4,1,1,6,新用户
1007202,2,1,1,4,1,1,6,新用户
1007221,8,1,1,1,1,1,3,一般用户
1007225,0,3,3,4,2,2,8,潜力用户
1007231,4,6,6,2,3,3,8,流失高价值用户
1007246,0,1,1,4,1,1,6,新用户
1007248,1,4,4,4,3,3,10,高价值用户
1007250,1,1,1,4,1,1,6,新用户
1007255,5,3,3,2,2,2,6,一般用户
1007260,4,1,1,2,1,1,4,一般用户
1007317,3,2,2,3,1,1,5,新用户
1007319,1,5,5,4,3,3,10,高价值用户
1007323,3,1,1,3,1,1,5,新用户
1007334,8,1,1,1,1,1,3,一般用户
1007335,0,14,14,4,3,3,10,高价值用户
1007339,0,2,2,4,1,1,6,新用户
1007349,1,2,2,4,1,1,6,新用户
1007356,1,2,2,4,1,1,6,新用户
1007387,4,1,1,2,1,1,4,一般用户
1007388,5,2,2,2,1,1,4,一般用户
1007391,2,3,3,4,2,2,8,潜力用户
1007393,1,1,1,4,1,1,6,新用户
1007401,1,1,1,4,1,1,6,新用户
1007402,3,2,2,3,1,1,5,新用户
1007441,1,2,2,4,1,1,6,新用户
1007445,1,2,2,4,1,1,6,新用户
1007452,8,1,1,1,1,1,3,一般用户
1007476,0,1,1,4,1,1,6,新用户
1007479,1,2,2,4,1,1,6,新用户
1007484,7,2,2,1,1,1,3,一般用户
1007495,8,1,1,1,1,1,3,一般用户
1007501,0,7,7,4,3,3,10,高价值用户
1007503,0,1,1,4,1,1,6,新用户
1007511,3,2,2,3,1,1,5,新用户
1007513,6,2,2,1,1,1,3,一般用户
1007539,5,1,1,2,1,1,4,一般用户
1007579,1,4,4,4,3,3,10,高价值用户
1007595,8,3,3,1,2,2,5,一般用户
1007596,4,2,2,2,1,1,4,一般用户
1007601,0,4,4,4,3,3,10,高价值用户
1007609,2,1,1,4,1,1,6,新用户
1007617,7,1,1,1,1,1,3,一般用户
1007624,0,1,1,4,1,1,6,新用户
1007629,0,2,2,4,1,1,6,新用户
1007635,5,1,1,2,1,1,4,一般用户
1007642,5,1,1,2,1,1,4,一般用户
1007659,7,1,1,1,1,1,3,一般用户
1007670,0,15,15,4,3,3,10,高价值用户
1007671,1,2,2,4,1,1,6,新用户
1007688,3,2,2,3,1,1,5,新用户
1007691,0,1,1,4,1,1,6,新用户
1007699,0,1,1,4,1,1,6,新用户
1007704,2,3,3,4,2,2,8,潜力用户
1007712,8,1,1,1,1,1,3,一般用户
1007739,1,1,1,4,1,1,6,新用户
1007747,2,2,2,4,1,1,6,新用户
1007755,1,2,2,4,1,1,6,新用户
1007770,3,3,3,3,2,2,7,潜力用户
1007778,3,1,1,3,1,1,5,新用户
1007782,2,1,1,4,1,1,6,新用户
1007786,2,8,8,4,3,3,10,高价值用户
1007802,0,3,3,4,2,2,8,潜力用户
1007808,8,1,1,1,1,1,3,一般用户
1007819,5,1,1,2,1,1,4,一般用户
1007839,3,1,1,3,1,1,5,新用户
1007843,0,1,1,4,1,1,6,新用户
1007848,2,4,4,4,3,3,10,高价值用户
1007857,2,2,2,4,1,1,6,新用户
1007860,0,1,1,4,1,1,6,新用户
1007884,3,2,2,3,1,1,5,新用户
1007907,2,1,1,4,1,1,6,新用户
1007912,2,11,11,4,3,3,10,高价值用户
1007919,0,4,4,4,3,3,10,高价值用户
1007925,2,4,4,4,3,3,10,高价值用户
1007934,3,2,2,3,1,1,5,新用户
1007944,4,2,2,2,1,1,4,一般用户
1007952,0,7,7,4,3,3,10,高价值用户
1007963,7,3,3,1,2,2,5,一般用户
1007965,6,3,3,1,2,2,5,一般用户
1007976,6,1,1,1,1,1,3,一般用户
1007993,2,1,1,4,1,1,6,新用户
1008003,5,1,1,2,1,1,4,一般用户
1008010,5,1,1,2,1,1,4,一般用户
1008037,4,1,1,2,1,1,4,一般用户
1008042,2,1,1,4,1,1,6,新用户
1008044,7,1,1,1,1,1,3,一般用户
1008062,2,2,2,4,1,1,6,新用户
1008065,8,1,1,1,1,1,3,一般用户
1008078,3,1,1,3,1,1,5,新用户
1008082,1,2,2,4,1,1,6,新用户
1008085,4,8,8,2,3,3,8,流失高价值用户
1008097,4,1,1,2,1,1,4,一般用户
1008100,0,4,4,4,3,3,10,高价值用户
1008106,0,1,1,4,1,1,6,新用户
1008107,2,1,1,4,1,1,6,新用户
1008131,2,4,4,4,3,3,10,高价值用户
1008137,1,4,4,4,3,3,10,高价值用户
1008151,1,1,1,4,1,1,6,新用户
1008152,3,1,1,3,1,1,5,新用户
1008174,0,5,5,4,3,3,10,高价值用户
1008184,2,1,1,4,1,1,6,新用户
1008212,2,2,2,4,1,1,6,新用户
1008215,4,1,1,2,1,1,4,一般用户
1008221,1,5,5,4,3,3,10,高价值用户
1008230,2,5,5,4,3,3,10,高价值用户
1008231,5,1,1,2,1,1,4,一般用户
1008241,3,2,2,3,1,1,5,新用户
1008245,0,3,3,4,2,2,8,潜力用户
1008253,1,1,1,4,1,1,6,新用户
1008255,6,1,1,1,1,1,3,一般用户
1008275,1,1,1,4,1,1,6,新用户
1008289,3,1,1,3,1,1,5,新用户
1008295,7,1,1,1,1,1,3,一般用户
1008302,1,1,1,4,1,1,6,新用户
1008366,4,2,2,2,1,1,4,一般用户
1008370,0,2,2,4,1,1,6,新用户
1008378,0,2,2,4,1,1,6,新用户
1008380,4,50,50,2,3,3,8,流失高价值用户
1008385,6,2,2,1,1,1,3,一般用户
1008387,2,1,1,4,1,1,6,新用户
1008391,0,4,4,4,3,3,10,高价值用户
1008392,1,1,1,4,1,1,6,新用户
1008405,3,3,3,3,2,2,7,潜力用户
1008415,8,1,1,1,1,1,3,一般用户
1008429,6,1,1,1,1,1,3,一般用户
1008430,0,3,3,4,2,2,8,潜力用户
1008481,5,1,1,2,1,1,4,一般用户
1008500,6,1,1,1,1,1,3,一般用户
1008502,5,2,2,2,1,1,4,一般用户
1008531,3,1,1,3,1,1,5,新用户
1008557,0,2,2,4,1,1,6,新用户
1008586,0,2,2,4,1,1,6,新用户
1008587,1,3,3,4,2,2,8,潜力用户
1008612,7,1,1,1,1,1,3,一般用户
1008614,0,3,3,4,2,2,8,潜力用户
1008681,2,4,4,4,3,3,10,高价值用户
1008685,8,1,1,1,1,1,3,一般用户
1008711,7,1,1,1,1,1,3,一般用户
1008726,4,1,1,2,1,1,4,一般用户
1008729,1,1,1,4,1,1,6,新用户
1008737,8,1,1,1,1,1,3,一般用户
1008744,4,1,1,2,1,1,4,一般用户
1008748,3,2,2,3,1,1,5,新用户
1008764,5,2,2,2,1,1,4,一般用户
1008777,1,1,1,4,1,1,6,新用户
1008786,1,6,6,4,3,3,10,高价值用户
1008793,1,1,1,4,1,1,6,新用户
1008794,5,1,1,2,1,1,4,一般用户
1008799,5,14,14,2,3,3,8,流失高价值用户
1008820,2,3,3,4,2,2,8,潜力用户
1008830,5,17,17,2,3,3,8,流失高价值用户
1008832,7,1,1,1,1,1,3,一般用户
1008834,3,2,2,3,1,1,5,新用户
1008842,0,6,6,4,3,3,10,高价值用户
1008846,0,1,1,4,1,1,6,新用户
1008849,3,1,1,3,1,1,5,新用户
1008868,7,1,1,1,1,1,3,一般用户
1008870,5,1,1,2,1,1,4,一般用户
1008879,1,1,1,4,1,1,6,新用户
1008882,1,2,2,4,1,1,6,新用户
1008883,4,3,3,2,2,2,6,一般用户
1008891,2,1,1,4,1,1,6,新用户
1008899,6,1,1,1,1,1,3,一般用户
1008904,0,6,6,4,3,3,10,高价值用户
1008905,3,1,1,3,1,1,5,新用户
1008916,0,5,5,4,3,3,10,高价值用户
1008933,1,2,2,4,1,1,6,新用户
1008956,4,1,1,2,1,1,4,一般用户
1008961,0,2,2,4,1,1,6,新用户
1008963,1,1,1,4,1,1,6,新用户
1008972,5,3,3,2,2,2,6,一般用户
1008985,6,1,1,1,1,1,3,一般用户
1008993,3,5,5,3,3,3,9,高价值用户
1008994,3,8,8,3,3,3,9,高价值用户
1009005,7,2,2,1,1,1,3,一般用户
1009013,2,5,5,4,3,3,10,高价值用户
1009021,2,2,2,4,1,1,6,新用户
1009026,0,1,1,4,1,1,6,新用户
1009046,0,4,4,4,3,3,10,高价值用户
1009070,1,7,7,4,3,3,10,高价值用户
1009104,0,1,1,4,1,1,6,新用户
1009107,7,1,1,1,1,1,3,一般用户
1009121,1,3,3,4,2,2,8,潜力用户
1009129,0,3,3,4,2,2,8,潜力用户
1009135,0,1,1,4,1,1,6,新用户
1009141,7,1,1,1,1,1,3,一般用户
1009153,0,2,2,4,1,1,6,新用户
1009155,4,3,3,2,2,2,6,一般用户
1009158,1,2,2,4,1,1,6,新用户
1009202,4,2,2,2,1,1,4,一般用户
1009211,1,1,1,4,1,1,6,新用户
1009217,2,1,1,4,1,1,6,新用户
1009221,0,2,2,4,1,1,6,新用户
1009225,4,1,1,2,1,1,4,一般用户
1009233,8,1,1,1,1,1,3,一般用户
1009237,5,2,2,2,1,1,4,一般用户
1009243,0,1,1,4,1,1,6,新用户
1009254,3,1,1,3,1,1,5,新用户
1009257,4,4,4,2,3,3,8,流失高价值用户
1009283,7,2,2,1,1,1,3,一般用户
1009285,2,4,4,4,3,3,10,高价值用户
1009328,0,1,1,4,1,1,6,新用户
1009352,0,1,1,4,1,1,6,新用户
1009384,3,1,1,3,1,1,5,新用户
1009385,7,2,2,1,1,1,3,一般用户
1009391,7,1,1,1,1,1,3,一般用户
1009402,2,1,1,4,1,1,6,新用户
1009405,6,1,1,1,1,1,3,一般用户
1009407,2,1,1,4,1,1,6,新用户
1009410,3,1,1,3,1,1,5,新用户
1009418,7,1,1,1,1,1,3,一般用户
1009420,1,1,1,4,1,1,6,新用户
1009440,3,1,1,3,1,1,5,新用户
1009441,2,2,2,4,1,1,6,新用户
1009457,0,1,1,4,1,1,6,新用户
1009465,1,1,1,4,1,1,6,新用户
1009501,4,2,2,2,1,1,4,一般用户
1009508,0,2,2,4,1,1,6,新用户
1009512,2,2,2,4,1,1,6,新用户
1009516,2,4,4,4,3,3,10,高价值用户
1009524,0,2,2,4,1,1,6,新用户
1009532,1,5,5,4,3,3,10,高价值用户
1009533,5,2,2,2,1,1,4,一般用户
1009551,0,1,1,4,1,1,6,新用户
1009559,1,4,4,4,3,3,10,高价值用户
1009575,0,1,1,4,1,1,6,新用户
1009587,0,1,1,4,1,1,6,新用户
1009608,0,1,1,4,1,1,6,新用户
1009611,1,4,4,4,3,3,10,高价值用户
1009619,1,2,2,4,1,1,6,新用户
1009639,0,1,1,4,1,1,6,新用户
1009657,3,2,2,3,1,1,5,新用户
1009666,4,1,1,2,1,1,4,一般用户
1009673,8,2,2,1,1,1,3,一般用户
1009687,6,1,1,1,1,1,3,一般用户
1009712,3,2,2,3,1,1,5,新用户
1009718,2,2,2,4,1,1,6,新用户
1009719,2,1,1,4,1,1,6,新用户
1009722,5,2,2,2,1,1,4,一般用户
1009724,8,1,1,1,1,1,3,一般用户
1009741,4,2,2,2,1,1,4,一般用户
1009748,0,1,1,4,1,1,6,新用户
1009753,0,1,1,4,1,1,6,新用户
1009765,7,1,1,1,1,1,3,一般用户
1009768,1,3,3,4,2,2,8,潜力用户
1009771,1,1,1,4,1,1,6,新用户
1009798,7,1,1,1,1,1,3,一般用户
1009803,1,1,1,4,1,1,6,新用户
1009822,0,7,7,4,3,3,10,高价值用户
1009832,5,2,2,2,1,1,4,一般用户
1009833,0,3,3,4,2,2,8,潜力用户
1009853,0,1,1,4,1,1,6,新用户
1009859,6,2,2,1,1,1,3,一般用户
1009880,3,2,2,3,1,1,5,新用户
1009884,5,5,5,2,3,3,8,流失高价值用户
1009898,0,3,3,4,2,2,8,潜力用户
1009932,4,1,1,2,1,1,4,一般用户
1009933,5,1,1,2,1,1,4,一般用户
1009934,1,8,8,4,3,3,10,高价值用户
1009938,4,2,2,2,1,1,4,一般用户
1009947,8,1,1,1,1,1,3,一般用户
1009950,1,1,1,4,1,1,6,新用户
1009997,0,2,2,4,1,1,6,新用户
1010006,6,1,1,1,1,1,3,一般用户
1010016,1,2,2,4,1,1,6,新用户
1010017,0,2,2,4,1,1,6,新用户
1010032,2,2,2,4,1,1,6,新用户
1010040,0,3,3,4,2,2,8,潜力用户
1010043,2,2,2,4,1,1,6,新用户
1010044,3,1,1,3,1,1,5,新用户
1010047,5,1,1,2,1,1,4,一般用户
1010051,1,3,3,4,2,2,8,潜力用户
1010079,1,3,3,4,2,2,8,潜力用户
1010088,2,1,1,4,1,1,6,新用户
1010093,6,1,1,1,1,1,3,一般用户
1010121,5,1,1,2,1,1,4,一般用户
1010125,5,4,4,2,3,3,8,流失高价值用户
1010129,6,3,3,1,2,2,5,一般用户
1010133,2,1,1,4,1,1,6,新用户
1010149,2,1,1,4,1,1,6,新用户
1010155,4,1,1,2,1,1,4,一般用户
1010157,0,1,1,4,1,1,6,新用户
1010170,0,2,2,4,1,1,6,新用户
1010198,1,1,1,4,1,1,6,新用户
1010205,1,1,1,4,1,1,6,新用户
1010208,3,1,1,3,1,1,5,新用户
1010215,8,2,2,1,1,1,3,一般用户
1010219,1,13,13,4,3,3,10,高价值用户
1010267,5,4,4,2,3,3,8,流失高价值用户
1010279,8,1,1,1,1,1,3,一般用户
1010280,1,5,5,4,3,3,10,高价值用户
1010281,0,3,3,4,2,2,8,潜力用户
1010288,4,13,13,2,3,3,8,流失高价值用户
1010299,1,3,3,4,2,2,8,潜力用户
1010306,1,1,1,4,1,1,6,新用户
1010311,6,1,1,1,1,1,3,一般用户
1010325,3,1,1,3,1,1,5,新用户
1010327,7,4,4,1,3,3,7,流失高价值用户
1010333,2,11,11,4,3,3,10,高价值用户
1010347,8,1,1,1,1,1,3,一般用户
1010373,5,1,1,2,1,1,4,一般用户
1010376,0,1,1,4,1,1,6,新用户
1010381,2,2,2,4,1,1,6,新用户
1010391,4,2,2,2,1,1,4,一般用户
1010396,0,3,3,4,2,2,8,潜力用户
1010399,2,4,4,4,3,3,10,高价值用户
1010411,3,2,2,3,1,1,5,新用户
1010416,5,3,3,2,2,2,6,一般用户
1010418,2,2,2,4,1,1,6,新用户
1010427,8,1,1,1,1,1,3,一般用户
1010433,4,1,1,2,1,1,4,一般用户
1010439,6,1,1,1,1,1,3,一般用户
1010445,0,1,1,4,1,1,6,新用户
1010453,0,2,2,4,1,1,6,新用户
1010455,0,1,1,4,1,1,6,新用户
1010478,0,7,7,4,3,3,10,高价值用户
1010480,6,1,1,1,1,1,3,一般用户
1010504,1,2,2,4,1,1,6,新用户
1010507,6,3,3,1,2,2,5,一般用户
1010510,3,3,3,3,2,2,7,潜力用户
1010515,4,1,1,2,1,1,4,一般用户
1010533,4,2,2,2,1,1,4,一般用户
1010534,6,1,1,1,1,1,3,一般用户
1010537,4,1,1,2,1,1,4,一般用户
1010539,6,1,1,1,1,1,3,一般用户
1010560,3,5,5,3,3,3,9,高价值用户
1010564,1,1,1,4,1,1,6,新用户
1010566,7,2,2,1,1,1,3,一般用户
1010568,2,2,2,4,1,1,6,新用户
1010572,0,1,1,4,1,1,6,新用户
1010582,5,2,2,2,1,1,4,一般用户
1010590,3,1,1,3,1,1,5,新用户
1010593,0,1,1,4,1,1,6,新用户
1010596,6,1,1,1,1,1,3,一般用户
1010598,1,4,4,4,3,3,10,高价值用户
1010599,4,1,1,2,1,1,4,一般用户
1010603,2,6,6,4,3,3,10,高价值用户
1010638,6,1,1,1,1,1,3,一般用户
1010641,7,1,1,1,1,1,3,一般用户
1010655,3,1,1,3,1,1,5,新用户
1010658,1,1,1,4,1,1,6,新用户
1010664,3,1,1,3,1,1,5,新用户
1010690,0,1,1,4,1,1,6,新用户
1010691,0,3,3,4,2,2,8,潜力用户
1010697,3,1,1,3,1,1,5,新用户
1010704,2,3,3,4,2,2,8,潜力用户
1010706,4,1,1,2,1,1,4,一般用户
1010711,4,1,1,2,1,1,4,一般用户
1010713,0,1,1,4,1,1,6,新用户
1010736,3,1,1,3,1,1,5,新用户
1010754,1,2,2,4,1,1,6,新用户
1010755,1,3,3,4,2,2,8,潜力用户
1010765,0,1,1,4,1,1,6,新用户
1010780,1,1,1,4,1,1,6,新用户
1010784,6,2,2,1,1,1,3,一般用户
1010785,6,4,4,1,3,3,7,流失高价值用户
1010806,3,3,3,3,2,2,7,潜力用户
1010816,3,3,3,3,2,2,7,潜力用户
1010817,0,1,1,4,1,1,6,新用户
1010836,5,1,1,2,1,1,4,一般用户
1010839,0,4,4,4,3,3,10,高价值用户
1010853,8,1,1,1,1,1,3,一般用户
1010857,0,2,2,4,1,1,6,新用户
1010861,0,3,3,4,2,2,8,潜力用户
1010864,1,3,3,4,2,2,8,潜力用户
1010869,1,5,5,4,3,3,10,高价值用户
1010870,1,3,3,4,2,2,8,潜力用户
1010896,4,2,2,2,1,1,4,一般用户
1010899,8,1,1,1,1,1,3,一般用户
1010944,3,4,4,3,3,3,9,高价值用户
1010945,4,1,1,2,1,1,4,一般用户
1010947,3,2,2,3,1,1,5,新用户
1010953,5,2,2,2,1,1,4,一般用户
1010978,2,5,5,4,3,3,10,高价值用户
1010981,4,3,3,2,2,2,6,一般用户
1010995,6,1,1,1,1,1,3,一般用户
1011004,3,1,1,3,1,1,5,新用户
1011005,1,3,3,4,2,2,8,潜力用户
1011017,2,1,1,4,1,1,6,新用户
1011021,4,9,9,2,3,3,8,流失高价值用户
1011024,5,1,1,2,1,1,4,一般用户
1011036,4,1,1,2,1,1,4,一般用户
1011050,1,4,4,4,3,3,10,高价值用户
1011052,6,1,1,1,1,1,3,一般用户
1011079,5,1,1,2,1,1,4,一般用户
1011084,3,1,1,3,1,1,5,新用户
1011086,7,2,2,1,1,1,3,一般用户
1011092,6,1,1,1,1,1,3,一般用户
1011096,4,2,2,2,1,1,4,一般用户
1011100,1,1,1,4,1,1,6,新用户
1011108,2,2,2,4,1,1,6,新用户
1011120,4,2,2,2,1,1,4,一般用户
1011128,4,2,2,2,1,1,4,一般用户
1011169,2,1,1,4,1,1,6,新用户
1011171,6,1,1,1,1,1,3,一般用户
1011172,2,1,1,4,1,1,6,新用户
1011181,0,4,4,4,3,3,10,高价值用户
1011217,8,2,2,1,1,1,3,一般用户
1011219,2,3,3,4,2,2,8,潜力用户
1011222,3,1,1,3,1,1,5,新用户
1011235,5,2,2,2,1,1,4,一般用户
1011248,0,2,2,4,1,1,6,新用户
1011254,2,2,2,4,1,1,6,新用户
1011258,8,1,1,1,1,1,3,一般用户
1011272,1,2,2,4,1,1,6,新用户
1011290,7,1,1,1,1,1,3,一般用户
1011293,3,1,1,3,1,1,5,新用户
1011322,0,1,1,4,1,1,6,新用户
1011326,1,2,2,4,1,1,6,新用户
1011365,6,2,2,1,1,1,3,一般用户
1011388,3,1,1,3,1,1,5,新用户
1011390,1,13,13,4,3,3,10,高价值用户
1011391,5,1,1,2,1,1,4,一般用户
1011397,0,1,1,4,1,1,6,新用户
1011400,6,1,1,1,1,1,3,一般用户
1011419,6,1,1,1,1,1,3,一般用户
1011431,3,1,1,3,1,1,5,新用户
1011470,2,2,2,4,1,1,6,新用户
1011499,5,1,1,2,1,1,4,一般用户
1011521,5,1,1,2,1,1,4,一般用户
1011527,0,3,3,4,2,2,8,潜力用户
1011565,0,3,3,4,2,2,8,潜力用户
1011581,0,5,5,4,3,3,10,高价值用户
1011647,1,1,1,4,1,1,6,新用户
1011648,1,1,1,4,1,1,6,新用户
1011651,1,1,1,4,1,1,6,新用户
1011652,0,11,11,4,3,3,10,高价值用户
1011655,4,5,5,2,3,3,8,流失高价值用户
1011656,4,1,1,2,1,1,4,一般用户
1011669,3,1,1,3,1,1,5,新用户
1011676,5,1,1,2,1,1,4,一般用户
1011685,4,1,1,2,1,1,4,一般用户
1011697,3,1,1,3,1,1,5,新用户
1011698,5,1,1,2,1,1,4,一般用户
1011699,2,2,2,4,1,1,6,新用户
1011704,0,2,2,4,1,1,6,新用户
1011709,5,1,1,2,1,1,4,一般用户
1011725,7,2,2,1,1,1,3,一般用户
1011729,8,1,1,1,1,1,3,一般用户
1011730,1,1,1,4,1,1,6,新用户
1011745,5,4,4,2,3,3,8,流失高价值用户
1011749,4,1,1,2,1,1,4,一般用户
1011752,0,2,2,4,1,1,6,新用户
1011758,5,1,1,2,1,1,4,一般用户
1011789,4,1,1,2,1,1,4,一般用户
1011793,2,2,2,4,1,1,6,新用户
1011799,0,1,1,4,1,1,6,新用户
1011802,0,1,1,4,1,1,6,新用户
1011828,2,1,1,4,1,1,6,新用户
1011839,5,1,1,2,1,1,4,一般用户
1011868,0,1,1,4,1,1,6,新用户
1011872,0,11,11,4,3,3,10,高价值用户
1011880,1,2,2,4,1,1,6,新用户
1011892,2,1,1,4,1,1,6,新用户
1011919,0,2,2,4,1,1,6,新用户
1011937,6,2,2,1,1,1,3,一般用户
1011943,0,3,3,4,2,2,8,潜力用户
1011960,0,4,4,4,3,3,10,高价值用户
1011961,0,1,1,4,1,1,6,新用户
1011986,6,2,2,1,1,1,3,一般用户
1011996,0,6,6,4,3,3,10,高价值用户
1012000,1,1,1,4,1,1,6,新用户
1012012,5,1,1,2,1,1,4,一般用户
1012017,0,1,1,4,1,1,6,新用户
1012022,6,2,2,1,1,1,3,一般用户
1012031,7,2,2,1,1,1,3,一般用户
1012040,7,1,1,1,1,1,3,一般用户
1012048,3,3,3,3,2,2,7,潜力用户
1012050,3,1,1,3,1,1,5,新用户
1012060,4,1,1,2,1,1,4,一般用户
1012070,1,1,1,4,1,1,6,新用户
1012075,3,4,4,3,3,3,9,高价值用户
1012093,4,4,4,2,3,3,8,流失高价值用户
1012102,5,2,2,2,1,1,4,一般用户
1012104,1,2,2,4,1,1,6,新用户
1012105,3,8,8,3,3,3,9,高价值用户
1012110,3,1,1,3,1,1,5,新用户
1012125,0,2,2,4,1,1,6,新用户
1012133,1,1,1,4,1,1,6,新用户
1012148,3,2,2,3,1,1,5,新用户
1012155,0,1,1,4,1,1,6,新用户
1012222,0,1,1,4,1,1,6,新用户
1012232,0,3,3,4,2,2,8,潜力用户
1012252,8,2,2,1,1,1,3,一般用户
1012257,7,1,1,1,1,1,3,一般用户
1012275,0,7,7,4,3,3,10,高价值用户
1012277,3,4,4,3,3,3,9,高价值用户
1012284,6,2,2,1,1,1,3,一般用户
1012287,2,2,2,4,1,1,6,新用户
1012290,4,3,3,2,2,2,6,一般用户
1012293,4,3,3,2,2,2,6,一般用户
1012296,0,1,1,4,1,1,6,新用户
1012298,0,1,1,4,1,1,6,新用户
1012299,4,1,1,2,1,1,4,一般用户
1012313,8,1,1,1,1,1,3,一般用户
1012333,1,1,1,4,1,1,6,新用户
1012338,3,2,2,3,1,1,5,新用户
1012344,0,1,1,4,1,1,6,新用户
1012358,0,3,3,4,2,2,8,潜力用户
1012373,2,4,4,4,3,3,10,高价值用户
1012380,1,1,1,4,1,1,6,新用户
1012395,3,5,5,3,3,3,9,高价值用户
1012403,1,1,1,4,1,1,6,新用户
1012411,3,2,2,3,1,1,5,新用户
1012415,0,1,1,4,1,1,6,新用户
1012420,0,3,3,4,2,2,8,潜力用户
1012426,1,2,2,4,1,1,6,新用户
1012459,1,3,3,4,2,2,8,潜力用户
1012469,0,1,1,4,1,1,6,新用户
1012472,1,1,1,4,1,1,6,新用户
1012474,2,1,1,4,1,1,6,新用户
1012478,4,1,1,2,1,1,4,一般用户
1012489,7,1,1,1,1,1,3,一般用户
1012498,0,1,1,4,1,1,6,新用户
1012501,1,3,3,4,2,2,8,潜力用户
1012516,6,1,1,1,1,1,3,一般用户
1012524,4,1,1,2,1,1,4,一般用户
1012525,1,8,8,4,3,3,10,高价值用户
1012528,6,1,1,1,1,1,3,一般用户
1012534,7,1,1,1,1,1,3,一般用户
1012536,1,2,2,4,1,1,6,新用户
1012550,3,2,2,3,1,1,5,新用户
1012553,2,1,1,4,1,1,6,新用户
1012579,3,1,1,3,1,1,5,新用户
1012597,5,1,1,2,1,1,4,一般用户
1012621,1,1,1,4,1,1,6,新用户
1012638,4,1,1,2,1,1,4,一般用户
1012639,5,2,2,2,1,1,4,一般用户
1012645,7,3,3,1,2,2,5,一般用户
1012647,4,1,1,2,1,1,4,一般用户
1012664,6,1,1,1,1,1,3,一般用户
1012667,2,2,2,4,1,1,6,新用户
1012677,8,1,1,1,1,1,3,一般用户
1012682,0,3,3,4,2,2,8,潜力用户
1012693,4,2,2,2,1,1,4,一般用户
1012736,3,2,2,3,1,1,5,新用户
1012737,6,1,1,1,1,1,3,一般用户
1012741,4,4,4,2,3,3,8,流失高价值用户
1012745,0,4,4,4,3,3,10,高价值用户
1012774,6,1,1,1,1,1,3,一般用户
1012793,1,2,2,4,1,1,6,新用户
1012804,0,1,1,4,1,1,6,新用户
1012806,0,5,5,4,3,3,10,高价值用户
1012826,3,1,1,3,1,1,5,新用户
1012830,3,1,1,3,1,1,5,新用户
1012841,4,5,5,2,3,3,8,流失高价值用户
1012851,3,5,5,3,3,3,9,高价值用户
1012881,2,5,5,4,3,3,10,高价值用户
1012894,1,1,1,4,1,1,6,新用户
1012895,2,1,1,4,1,1,6,新用户
1012904,2,2,2,4,1,1,6,新用户
1012919,2,2,2,4,1,1,6,新用户
1012925,5,1,1,2,1,1,4,一般用户
1012950,3,1,1,3,1,1,5,新用户
1012985,3,2,2,3,1,1,5,新用户
1013004,6,2,2,1,1,1,3,一般用户
1013015,0,1,1,4,1,1,6,新用户
1013023,5,1,1,2,1,1,4,一般用户
1013030,1,1,1,4,1,1,6,新用户
1013086,6,5,5,1,3,3,7,流失高价值用户
1013088,3,1,1,3,1,1,5,新用户
1013089,5,1,1,2,1,1,4,一般用户
1013118,1,3,3,4,2,2,8,潜力用户
1013133,8,3,3,1,2,2,5,一般用户
1013136,1,2,2,4,1,1,6,新用户
1013169,1,2,2,4,1,1,6,新用户
1013180,0,1,1,4,1,1,6,新用户
1013202,0,1,1,4,1,1,6,新用户
1013209,0,3,3,4,2,2,8,潜力用户
1013238,1,1,1,4,1,1,6,新用户
1013240,1,2,2,4,1,1,6,新用户
1013265,0,1,1,4,1,1,6,新用户
1013277,0,1,1,4,1,1,6,新用户
1013305,0,1,1,4,1,1,6,新用户
1013311,5,1,1,2,1,1,4,一般用户
1013317,2,4,4,4,3,3,10,高价值用户
1013323,1,2,2,4,1,1,6,新用户
1013338,7,1,1,1,1,1,3,一般用户
1013343,3,4,4,3,3,3,9,高价值用户
1013355,8,1,1,1,1,1,3,一般用户
1013364,2,4,4,4,3,3,10,高价值用户
1013366,7,1,1,1,1,1,3,一般用户
1013370,4,1,1,2,1,1,4,一般用户
1013376,1,1,1,4,1,1,6,新用户
1013381,0,17,17,4,3,3,10,高价值用户
1013445,3,2,2,3,1,1,5,新用户
1013497,0,3,3,4,2,2,8,潜力用户
1013501,2,1,1,4,1,1,6,新用户
1013525,2,3,3,4,2,2,8,潜力用户
1013563,1,1,1,4,1,1,6,新用户
1013574,4,2,2,2,1,1,4,一般用户
1013579,2,2,2,4,1,1,6,新用户
1013585,7,1,1,1,1,1,3,一般用户
1013586,5,1,1,2,1,1,4,一般用户
1013593,1,1,1,4,1,1,6,新用户
1013606,2,1,1,4,1,1,6,新用户
1013611,1,1,1,4,1,1,6,新用户
1013635,5,1,1,2,1,1,4,一般用户
1013649,1,1,1,4,1,1,6,新用户
1013652,1,2,2,4,1,1,6,新用户
1013655,4,2,2,2,1,1,4,一般用户
1013678,1,2,2,4,1,1,6,新用户
1013687,3,1,1,3,1,1,5,新用户
1013690,3,3,3,3,2,2,7,潜力用户
1013691,2,1,1,4,1,1,6,新用户
1013697,4,3,3,2,2,2,6,一般用户
1013702,0,1,1,4,1,1,6,新用户
1013706,7,2,2,1,1,1,3,一般用户
1013709,4,4,4,2,3,3,8,流失高价值用户
1013711,6,2,2,1,1,1,3,一般用户
1013712,8,1,1,1,1,1,3,一般用户
1013728,1,5,5,4,3,3,10,高价值用户
1013742,4,3,3,2,2,2,6,一般用户
1013747,3,5,5,3,3,3,9,高价值用户
1013765,1,4,4,4,3,3,10,高价值用户
1013785,4,1,1,2,1,1,4,一般用户
1013787,8,1,1,1,1,1,3,一般用户
1013829,3,1,1,3,1,1,5,新用户
1013830,6,2,2,1,1,1,3,一般用户
1013835,7,1,1,1,1,1,3,一般用户
1013844,5,1,1,2,1,1,4,一般用户
1013847,5,5,5,2,3,3,8,流失高价值用户
1013889,0,2,2,4,1,1,6,新用户
1013893,1,1,1,4,1,1,6,新用户
1013911,7,2,2,1,1,1,3,一般用户
1013920,1,1,1,4,1,1,6,新用户
1013933,2,2,2,4,1,1,6,新用户
1013942,3,2,2,3,1,1,5,新用户
1013943,1,8,8,4,3,3,10,高价值用户
1013961,1,2,2,4,1,1,6,新用户
1013967,0,2,2,4,1,1,6,新用户
1013991,0,1,1,4,1,1,6,新用户
1014022,4,2,2,2,1,1,4,一般用户
1014034,2,1,1,4,1,1,6,新用户
1014035,5,3,3,2,2,2,6,一般用户
1014045,7,2,2,1,1,1,3,一般用户
1014046,2,2,2,4,1,1,6,新用户
1014048,3,2,2,3,1,1,5,新用户
1014059,1,2,2,4,1,1,6,新用户
1014064,5,2,2,2,1,1,4,一般用户
1014069,0,1,1,4,1,1,6,新用户
1014072,0,3,3,4,2,2,8,潜力用户
1014096,6,1,1,1,1,1,3,一般用户
1014108,5,3,3,2,2,2,6,一般用户
1014150,8,1,1,1,1,1,3,一般用户
1014152,1,1,1,4,1,1,6,新用户
1014153,6,1,1,1,1,1,3,一般用户
1014154,3,2,2,3,1,1,5,新用户
1014156,1,2,2,4,1,1,6,新用户
1014166,8,2,2,1,1,1,3,一般用户
1014176,8,1,1,1,1,1,3,一般用户
1014180,8,1,1,1,1,1,3,一般用户
1014197,2,3,3,4,2,2,8,潜力用户
1014207,7,1,1,1,1,1,3,一般用户
1014237,0,3,3,4,2,2,8,潜力用户
1014248,7,1,1,1,1,1,3,一般用户
1014265,2,5,5,4,3,3,10,高价值用户
1014275,1,2,2,4,1,1,6,新用户
1014279,1,1,1,4,1,1,6,新用户
1014281,0,5,5,4,3,3,10,高价值用户
1014286,7,1,1,1,1,1,3,一般用户
1014291,1,2,2,4,1,1,6,新用户
1014313,4,2,2,2,1,1,4,一般用户
1014321,7,4,4,1,3,3,7,流失高价值用户
1014326,5,1,1,2,1,1,4,一般用户
1014332,3,1,1,3,1,1,5,新用户
1014341,0,5,5,4,3,3,10,高价值用户
1014344,0,2,2,4,1,1,6,新用户
1014352,3,1,1,3,1,1,5,新用户
1014357,2,2,2,4,1,1,6,新用户
1014362,7,1,1,1,1,1,3,一般用户
1014366,6,1,1,1,1,1,3,一般用户
1014391,7,1,1,1,1,1,3,一般用户
1014418,4,11,11,2,3,3,8,流失高价值用户
1014427,2,4,4,4,3,3,10,高价值用户
1014446,4,5,5,2,3,3,8,流失高价值用户
1014449,3,1,1,3,1,1,5,新用户
1014458,8,1,1,1,1,1,3,一般用户
1014467,8,1,1,1,1,1,3,一般用户
1014472,5,1,1,2,1,1,4,一般用户
1014475,4,4,4,2,3,3,8,流失高价值用户
1014477,5,2,2,2,1,1,4,一般用户
1014508,7,1,1,1,1,1,3,一般用户
1014517,0,1,1,4,1,1,6,新用户
1014519,5,2,2,2,1,1,4,一般用户
1014544,3,4,4,3,3,3,9,高价值用户
1014550,2,1,1,4,1,1,6,新用户
1014557,2,5,5,4,3,3,10,高价值用户
1014577,1,3,3,4,2,2,8,潜力用户
1014597,7,1,1,1,1,1,3,一般用户
1014605,5,1,1,2,1,1,4,一般用户
1014610,3,16,16,3,3,3,9,高价值用户
1014617,0,1,1,4,1,1,6,新用户
1014637,4,1,1,2,1,1,4,一般用户
1014652,0,3,3,4,2,2,8,潜力用户
1014679,4,1,1,2,1,1,4,一般用户
1014694,5,5,5,2,3,3,8,流失高价值用户
1014695,0,2,2,4,1,1,6,新用户
1014708,3,1,1,3,1,1,5,新用户
1014715,8,2,2,1,1,1,3,一般用户
1014716,5,5,5,2,3,3,8,流失高价值用户
1014732,3,3,3,3,2,2,7,潜力用户
1014736,6,3,3,1,2,2,5,一般用户
1014755,3,1,1,3,1,1,5,新用户
1014758,3,1,1,3,1,1,5,新用户
1014778,5,1,1,2,1,1,4,一般用户
1014782,3,1,1,3,1,1,5,新用户
1014786,1,1,1,4,1,1,6,新用户
1014789,1,2,2,4,1,1,6,新用户
1014817,0,2,2,4,1,1,6,新用户
1014838,0,1,1,4,1,1,6,新用户
1014840,3,2,2,3,1,1,5,新用户
1014880,0,2,2,4,1,1,6,新用户
1014896,1,1,1,4,1,1,6,新用户
1014907,0,4,4,4,3,3,10,高价值用户
1014909,5,1,1,2,1,1,4,一般用户
1014912,1,2,2,4,1,1,6,新用户
1014917,5,3,3,2,2,2,6,一般用户
1014935,0,2,2,4,1,1,6,新用户
1014939,5,2,2,2,1,1,4,一般用户
1014959,3,4,4,3,3,3,9,高价值用户
1014989,3,1,1,3,1,1,5,新用户
1015014,6,1,1,1,1,1,3,一般用户
1015027,3,1,1,3,1,1,5,新用户
1015031,7,1,1,1,1,1,3,一般用户
1015032,0,1,1,4,1,1,6,新用户
1015045,1,1,1,4,1,1,6,新用户
1015047,5,1,1,2,1,1,4,一般用户
1015055,1,2,2,4,1,1,6,新用户
1015060,1,2,2,4,1,1,6,新用户
1015065,3,1,1,3,1,1,5,新用户
1015075,2,2,2,4,1,1,6,新用户
1015077,6,2,2,1,1,1,3,一般用户
1015099,2,3,3,4,2,2,8,潜力用户
1015103,3,1,1,3,1,1,5,新用户
1015112,2,2,2,4,1,1,6,新用户
1015115,6,1,1,1,1,1,3,一般用户
1015117,0,3,3,4,2,2,8,潜力用户
1015130,1,1,1,4,1,1,6,新用户
1015143,4,1,1,2,1,1,4,一般用户
1015171,3,1,1,3,1,1,5,新用户
1015181,1,1,1,4,1,1,6,新用户
1015184,0,1,1,4,1,1,6,新用户
1015186,4,1,1,2,1,1,4,一般用户
1015193,1,3,3,4,2,2,8,潜力用户
1015219,3,9,9,3,3,3,9,高价值用户
1015229,0,2,2,4,1,1,6,新用户
1015234,5,1,1,2,1,1,4,一般用户
1015237,2,1,1,4,1,1,6,新用户
1015253,1,2,2,4,1,1,6,新用户
1015255,0,21,21,4,3,3,10,高价值用户
1015272,2,2,2,4,1,1,6,新用户
1015278,2,1,1,4,1,1,6,新用户
1015279,4,1,1,2,1,1,4,一般用户
1015280,1,1,1,4,1,1,6,新用户
1015328,4,3,3,2,2,2,6,一般用户
1015330,1,6,6,4,3,3,10,高价值用户
1015342,2,1,1,4,1,1,6,新用户
1015344,1,1,1,4,1,1,6,新用户
1015357,6,1,1,1,1,1,3,一般用户
1015375,3,1,1,3,1,1,5,新用户
1015386,1,3,3,4,2,2,8,潜力用户
1015394,3,2,2,3,1,1,5,新用户
1015399,7,1,1,1,1,1,3,一般用户
1015403,1,2,2,4,1,1,6,新用户
1015430,5,1,1,2,1,1,4,一般用户
1015454,1,2,2,4,1,1,6,新用户
1015458,1,1,1,4,1,1,6,新用户
1015460,8,1,1,1,1,1,3,一般用户
1015469,0,3,3,4,2,2,8,潜力用户
1015471,4,6,6,2,3,3,8,流失高价值用户
1015531,6,1,1,1,1,1,3,一般用户
1015539,7,1,1,1,1,1,3,一般用户
1015545,3,3,3,3,2,2,7,潜力用户
1015548,4,2,2,2,1,1,4,一般用户
1015554,1,2,2,4,1,1,6,新用户
1015568,7,2,2,1,1,1,3,一般用户
1015572,4,2,2,2,1,1,4,一般用户
1015573,7,2,2,1,1,1,3,一般用户
1015574,7,1,1,1,1,1,3,一般用户
1015578,4,2,2,2,1,1,4,一般用户
1015591,3,6,6,3,3,3,9,高价值用户
1015592,1,1,1,4,1,1,6,新用户
1015600,1,2,2,4,1,1,6,新用户
1015602,5,1,1,2,1,1,4,一般用户
1015621,5,2,2,2,1,1,4,一般用户
1015645,6,1,1,1,1,1,3,一般用户
1015656,5,1,1,2,1,1,4,一般用户
1015673,0,2,2,4,1,1,6,新用户
1015678,4,7,7,2,3,3,8,流失高价值用户
1015695,0,1,1,4,1,1,6,新用户
1015702,7,2,2,1,1,1,3,一般用户
1015706,0,3,3,4,2,2,8,潜力用户
1015719,3,1,1,3,1,1,5,新用户
1015742,1,1,1,4,1,1,6,新用户
1015745,8,1,1,1,1,1,3,一般用户
1015754,0,20,20,4,3,3,10,高价值用户
1015756,3,9,9,3,3,3,9,高价值用户
1015760,0,6,6,4,3,3,10,高价值用户
1015770,4,1,1,2,1,1,4,一般用户
1015772,2,3,3,4,2,2,8,潜力用户
1015794,0,3,3,4,2,2,8,潜力用户
1015809,6,1,1,1,1,1,3,一般用户
1015811,5,2,2,2,1,1,4,一般用户
1015814,6,2,2,1,1,1,3,一般用户
1015831,3,2,2,3,1,1,5,新用户
1015840,4,1,1,2,1,1,4,一般用户
1015846,6,3,3,1,2,2,5,一般用户
1015856,0,2,2,4,1,1,6,新用户
1015870,1,2,2,4,1,1,6,新用户
1015875,2,1,1,4,1,1,6,新用户
1015886,2,6,6,4,3,3,10,高价值用户
1015887,6,2,2,1,1,1,3,一般用户
1015888,0,2,2,4,1,1,6,新用户
1015890,1,2,2,4,1,1,6,新用户
1015903,6,2,2,1,1,1,3,一般用户
1015910,2,1,1,4,1,1,6,新用户
1015962,2,1,1,4,1,1,6,新用户
1015966,0,3,3,4,2,2,8,潜力用户
1015974,3,1,1,3,1,1,5,新用户
1015981,5,1,1,2,1,1,4,一般用户
1015982,1,1,1,4,1,1,6,新用户
1015986,2,1,1,4,1,1,6,新用户
1015988,1,7,7,4,3,3,10,高价值用户
1016016,0,3,3,4,2,2,8,潜力用户
1016020,1,2,2,4,1,1,6,新用户
1016024,0,2,2,4,1,1,6,新用户
1016054,0,3,3,4,2,2,8,潜力用户
1016078,5,2,2,2,1,1,4,一般用户
1016093,0,1,1,4,1,1,6,新用户
1016137,0,3,3,4,2,2,8,潜力用户
1016156,0,3,3,4,2,2,8,潜力用户
1016185,1,2,2,4,1,1,6,新用户
1016191,3,4,4,3,3,3,9,高价值用户
1016193,7,2,2,1,1,1,3,一般用户
1016201,6,1,1,1,1,1,3,一般用户
1016203,4,2,2,2,1,1,4,一般用户
1016219,7,2,2,1,1,1,3,一般用户
1016228,7,1,1,1,1,1,3,一般用户
1016234,0,4,4,4,3,3,10,高价值用户
1016237,1,1,1,4,1,1,6,新用户
1016247,2,1,1,4,1,1,6,新用户
1016260,7,1,1,1,1,1,3,一般用户
1016277,0,2,2,4,1,1,6,新用户
1016284,3,1,1,3,1,1,5,新用户
1016293,3,1,1,3,1,1,5,新用户
1016299,4,3,3,2,2,2,6,一般用户
1016302,1,1,1,4,1,1,6,新用户
1016304,2,5,5,4,3,3,10,高价值用户
1016318,7,2,2,1,1,1,3,一般用户
1016326,0,6,6,4,3,3,10,高价值用户
1016334,7,4,4,1,3,3,7,流失高价值用户
1016342,1,2,2,4,1,1,6,新用户
1016357,5,5,5,2,3,3,8,流失高价值用户
1016384,0,1,1,4,1,1,6,新用户
1016385,2,2,2,4,1,1,6,新用户
1016393,5,1,1,2,1,1,4,一般用户
1016394,6,1,1,1,1,1,3,一般用户
1016415,8,1,1,1,1,1,3,一般用户
1016430,1,2,2,4,1,1,6,新用户
1016457,8,1,1,1,1,1,3,一般用户
1016465,5,3,3,2,2,2,6,一般用户
1016467,3,4,4,3,3,3,9,高价值用户
1016474,7,1,1,1,1,1,3,一般用户
1016479,1,1,1,4,1,1,6,新用户
1016498,0,4,4,4,3,3,10,高价值用户
1016501,0,1,1,4,1,1,6,新用户
1016502,4,2,2,2,1,1,4,一般用户
1016512,1,1,1,4,1,1,6,新用户
1016554,4,1,1,2,1,1,4,一般用户
1016559,2,2,2,4,1,1,6,新用户
1016560,2,1,1,4,1,1,6,新用户
1016562,3,2,2,3,1,1,5,新用户
1016568,4,1,1,2,1,1,4,一般用户
1016572,7,1,1,1,1,1,3,一般用户
1016579,1,1,1,4,1,1,6,新用户
1016582,0,4,4,4,3,3,10,高价值用户
1016605,7,1,1,1,1,1,3,一般用户
1016622,1,5,5,4,3,3,10,高价值用户
1016639,0,6,6,4,3,3,10,高价值用户
1016653,0,1,1,4,1,1,6,新用户
1016670,4,1,1,2,1,1,4,一般用户
1016682,8,1,1,1,1,1,3,一般用户
1016689,8,2,2,1,1,1,3,一般用户
1016696,4,1,1,2,1,1,4,一般用户
1016700,2,2,2,4,1,1,6,新用户
1016710,8,2,2,1,1,1,3,一般用户
1016711,1,3,3,4,2,2,8,潜力用户
1016731,6,1,1,1,1,1,3,一般用户
1016733,6,1,1,1,1,1,3,一般用户
1016741,1,1,1,4,1,1,6,新用户
1016743,3,1,1,3,1,1,5,新用户
1016747,0,2,2,4,1,1,6,新用户
1016759,4,1,1,2,1,1,4,一般用户
1016774,3,2,2,3,1,1,5,新用户
1016783,8,1,1,1,1,1,3,一般用户
1016784,3,2,2,3,1,1,5,新用户
1016792,0,6,6,4,3,3,10,高价值用户
1016808,4,1,1,2,1,1,4,一般用户
1016810,5,2,2,2,1,1,4,一般用户
1016838,1,4,4,4,3,3,10,高价值用户
1016878,6,1,1,1,1,1,3,一般用户
1016912,4,19,19,2,3,3,8,流失高价值用户
1016916,7,1,1,1,1,1,3,一般用户
1016919,2,1,1,4,1,1,6,新用户
1016924,0,1,1,4,1,1,6,新用户
1016928,0,2,2,4,1,1,6,新用户
1016939,2,2,2,4,1,1,6,新用户
1016950,0,2,2,4,1,1,6,新用户
1016970,2,1,1,4,1,1,6,新用户
1016977,4,4,4,2,3,3,8,流失高价值用户
1016990,8,2,2,1,1,1,3,一般用户
1017005,4,2,2,2,1,1,4,一般用户
1017023,0,1,1,4,1,1,6,新用户
1017027,4,8,8,2,3,3,8,流失高价值用户
1017030,2,6,6,4,3,3,10,高价值用户
1017036,1,2,2,4,1,1,6,新用户
1017055,0,3,3,4,2,2,8,潜力用户
1017058,1,6,6,4,3,3,10,高价值用户
1017075,4,1,1,2,1,1,4,一般用户
1017085,2,2,2,4,1,1,6,新用户
1017105,2,10,10,4,3,3,10,高价值用户
1017107,0,1,1,4,1,1,6,新用户
1017110,3,2,2,3,1,1,5,新用户
1017117,6,2,2,1,1,1,3,一般用户
1017143,5,2,2,2,1,1,4,一般用户
1017170,1,3,3,4,2,2,8,潜力用户
1017209,6,2,2,1,1,1,3,一般用户
1017234,3,1,1,3,1,1,5,新用户
1017269,7,1,1,1,1,1,3,一般用户
1017277,3,2,2,3,1,1,5,新用户
1017284,3,2,2,3,1,1,5,新用户
1017304,6,1,1,1,1,1,3,一般用户
1017318,0,3,3,4,2,2,8,潜力用户
1017334,0,5,5,4,3,3,10,高价值用户
1017353,0,2,2,4,1,1,6,新用户
1017355,6,1,1,1,1,1,3,一般用户
1017364,1,1,1,4,1,1,6,新用户
1017368,1,1,1,4,1,1,6,新用户
1017378,2,1,1,4,1,1,6,新用户
1017379,1,2,2,4,1,1,6,新用户
1017392,1,1,1,4,1,1,6,新用户
1017407,1,3,3,4,2,2,8,潜力用户
1017417,1,1,1,4,1,1,6,新用户
1017453,0,1,1,4,1,1,6,新用户
1017456,4,2,2,2,1,1,4,一般用户
1017484,0,1,1,4,1,1,6,新用户
1017506,5,1,1,2,1,1,4,一般用户
1017509,1,2,2,4,1,1,6,新用户
1017515,0,2,2,4,1,1,6,新用户
1017522,4,1,1,2,1,1,4,一般用户
1017526,1,1,1,4,1,1,6,新用户
1017527,5,2,2,2,1,1,4,一般用户
1017543,0,5,5,4,3,3,10,高价值用户
1017546,6,2,2,1,1,1,3,一般用户
1017567,4,3,3,2,2,2,6,一般用户
1017574,4,1,1,2,1,1,4,一般用户
1017575,3,2,2,3,1,1,5,新用户
1017579,4,3,3,2,2,2,6,一般用户
1017580,0,2,2,4,1,1,6,新用户
1017582,3,1,1,3,1,1,5,新用户
1017585,4,2,2,2,1,1,4,一般用户
1017598,0,2,2,4,1,1,6,新用户
1017612,3,2,2,3,1,1,5,新用户
1017613,4,1,1,2,1,1,4,一般用户
1017615,3,2,2,3,1,1,5,新用户
1017619,3,2,2,3,1,1,5,新用户
1017621,5,1,1,2,1,1,4,一般用户
1017625,7,3,3,1,2,2,5,一般用户
1017627,0,4,4,4,3,3,10,高价值用户
1017649,0,3,3,4,2,2,8,潜力用户
1017670,1,4,4,4,3,3,10,高价值用户
1017674,5,1,1,2,1,1,4,一般用户
1017678,4,2,2,2,1,1,4,一般用户
1017719,3,3,3,3,2,2,7,潜力用户
1017734,5,3,3,2,2,2,6,一般用户
1017762,6,3,3,1,2,2,5,一般用户
1017770,5,3,3,2,2,2,6,一般用户
1017772,4,1,1,2,1,1,4,一般用户
1017773,1,2,2,4,1,1,6,新用户
1017785,2,4,4,4,3,3,10,高价值用户
1017806,5,1,1,2,1,1,4,一般用户
1017814,0,1,1,4,1,1,6,新用户
1017822,2,2,2,4,1,1,6,新用户
1017860,0,5,5,4,3,3,10,高价值用户
1017869,0,3,3,4,2,2,8,潜力用户
1017877,5,1,1,2,1,1,4,一般用户
1017894,0,1,1,4,1,1,6,新用户
1017902,0,8,8,4,3,3,10,高价值用户
1017904,4,1,1,2,1,1,4,一般用户
1017905,0,5,5,4,3,3,10,高价值用户
1017915,3,1,1,3,1,1,5,新用户
1017918,4,1,1,2,1,1,4,一般用户
1017927,1,1,1,4,1,1,6,新用户
1017938,1,2,2,4,1,1,6,新用户
1017958,0,1,1,4,1,1,6,新用户
1017960,0,1,1,4,1,1,6,新用户
1017965,6,1,1,1,1,1,3,一般用户
1017972,8,1,1,1,1,1,3,一般用户
1017997,8,1,1,1,1,1,3,一般用户
